GEOID,occupancy_rate,vacancy_rate,multiunit_struct,mobile_home_rate,pop_20yrs_plus,no_vehicle,public_transit,NAME,mobile_home,multiunits_10_to_19,multiunits_20_to_49,multiunits_50plus,multiunits_five_to_nine,multiunits_three_or_four,multiunits_two,occupied_owner,occupied_renter,occupied_units,pop_own_90_99,pop_own_bfr89,pop_own_occ,pop_ren_90_99,pop_ren_bfr89,pop_ren_occ,total_units,vacant_units,pop_own_20yrs_plus,pop_ren_20yrs_plus
34001000100,0.8014941302027748,0.19850586979722518,489,0,242,202,190,"Census Tract 1, Atlantic County, New Jersey",0,46,24,12,108,145,154,246,505,751,127,57,736,34,24,1406,937,186,184,58
34001000200,0.7050131926121372,0.2949868073878628,1255,0,807,335,487,"Census Tract 2, Atlantic County, New Jersey",0,66,65,667,159,31,267,747,589,1336,323,235,1807,159,90,1489,1895,559,558,249
34001000300,0.7781173594132029,0.22188264058679708,1328,0,213,466,585,"Census Tract 3, Atlantic County, New Jersey",0,122,88,145,277,322,374,267,1006,1273,94,62,661,30,27,3533,1636,363,156,57
34001000400,0.5629528985507246,0.4370471014492754,1885,0.005434782608695652,432,523,286,"Census Tract 4, Atlantic County, New Jersey",12,175,174,1136,77,162,161,411,832,1243,192,12,841,205,23,2080,2208,965,204,228
34001000500,0.8124419684308264,0.18755803156917364,574,0,598,281,334,"Census Tract 5, Atlantic County, New Jersey",0,0,0,45,134,239,156,372,503,875,356,122,1519,84,36,1779,1077,202,478,120
34001001100,0.8172727272727273,0.18272727272727274,771,0,181,582,100,"Census Tract 11, Atlantic County, New Jersey",0,189,43,246,141,67,85,72,827,899,11,92,148,59,19,1734,1100,201,103,78
34001001200,0.8191556395715186,0.1808443604284814,627,0.007561436672967864,765,328,139,"Census Tract 12, Atlantic County, New Jersey",12,110,63,78,105,94,177,512,788,1300,244,289,1265,182,50,1773,1587,287,533,232
34001001300,0.7287234042553191,0.2712765957446808,371,0.019148936170212766,507,187,76,"Census Tract 13, Atlantic County, New Jersey",18,170,37,0,35,81,48,341,344,685,199,230,809,60,18,753,940,255,429,78
34001001400,0.8597852028639618,0.14021479713603818,1025,0,497,642,196,"Census Tract 14, Atlantic County, New Jersey",0,176,74,268,398,64,45,328,1113,1441,46,180,510,208,63,3023,1676,235,226,271
34001001500,0.8717948717948718,0.1282051282051282,563,0,210,465,79,"Census Tract 15, Atlantic County, New Jersey",0,70,4,342,20,36,91,44,738,782,0,20,115,50,140,1627,897,115,20,190
34001001900,0.6666666666666666,0.3333333333333333,1017,0,223,331,191,"Census Tract 19, Atlantic County, New Jersey",0,31,8,837,21,85,35,59,665,724,74,0,216,94,55,1197,1086,362,74,149
34001002300,0.7529880478087649,0.24701195219123506,593,0,367,408,281,"Census Tract 23, Atlantic County, New Jersey",0,56,12,0,87,175,263,221,535,756,279,81,828,7,0,1641,1004,248,360,7
34001002400,0.717948717948718,0.28205128205128205,1459,0,103,694,279,"Census Tract 24, Atlantic County, New Jersey",0,214,273,752,135,63,22,123,1053,1176,0,33,209,70,0,2167,1638,462,33,70
34001002500,0.8396031417941298,0.16039685820587019,1608,0,756,1168,502,"Census Tract 25, Atlantic County, New Jersey",0,186,31,1207,25,71,88,327,1704,2031,229,68,679,401,58,3073,2419,388,297,459
34001010101,0.48300536672629696,0.516994633273703,501,0.0032200357781753132,1421,80,24,"Census Tract 101.01, Atlantic County, New Jersey",9,108,130,37,20,61,145,1125,225,1350,889,407,2655,114,11,494,2795,1445,1296,125
34001010102,0.372354211663067,0.6276457883369331,744,0,730,92,60,"Census Tract 101.02, Atlantic County, New Jersey",0,104,125,213,82,56,164,635,227,862,373,300,1360,32,25,453,2315,1453,673,57
34001010104,0.3550351288056206,0.6449648711943794,1210,0,382,61,132,"Census Tract 101.04, Atlantic County, New Jersey",0,110,78,302,109,216,395,395,363,758,146,181,723,43,12,692,2135,1377,327,55
34001010105,0.4978485370051635,0.5021514629948365,629,0,704,86,71,"Census Tract 101.05, Atlantic County, New Jersey",0,206,23,80,21,51,248,842,315,1157,340,318,1801,7,39,783,2324,1167,658,46
34001010200,0.8873929008567931,0.11260709914320685,166,0.012239902080783354,2301,104,11,"Census Tract 102, Atlantic County, New Jersey",30,58,0,13,17,14,64,1995,180,2175,1509,792,5222,0,0,490,2451,276,2301,0
34001010300,0.8683712121212122,0.13162878787878787,446,0,771,116,130,"Census Tract 103, Atlantic County, New Jersey",0,216,13,11,83,27,96,586,331,917,201,237,1459,286,47,964,1056,139,438,333
34001010401,0.8631619636644762,0.13683803633552377,524,0.004638577502899111,2267,87,0,"Census Tract 104.01, Atlantic County, New Jersey",12,90,18,40,236,140,0,1711,522,2233,1199,947,4810,82,39,1068,2587,354,2146,121
34001010403,0.9536307961504812,0.04636920384951881,284,0,1547,170,46,"Census Tract 104.03, Atlantic County, New Jersey",0,0,105,59,0,80,40,1816,364,2180,888,596,5898,41,22,791,2286,106,1484,63
34001010501,0.8581363004172462,0.14186369958275383,724,0.004728789986091794,2127,162,23,"Census Tract 105.01, Atlantic County, New Jersey",17,51,0,26,268,316,63,2650,435,3085,1306,749,5884,21,51,974,3595,510,2055,72
34001010503,0.8598237133920955,0.14017628660790446,1808,0,1549,296,345,"Census Tract 105.03, Atlantic County, New Jersey",0,436,266,119,741,172,74,1639,1385,3024,884,496,3891,169,0,3563,3517,493,1380,169
34001010505,0.7819672131147541,0.2180327868852459,143,0,1259,9,18,"Census Tract 105.05, Atlantic County, New Jersey",0,0,120,0,23,0,0,936,18,954,619,631,2620,9,0,18,1220,266,1250,9
34001010506,0.9010050251256282,0.09899497487437187,259,0.033165829145728645,1924,193,51,"Census Tract 105.06, Atlantic County, New Jersey",66,74,0,8,108,39,30,1461,332,1793,1195,729,4176,0,0,1085,1990,197,1924,0
34001010600,0.8626476072094469,0.13735239279055314,551,0,782,150,56,"Census Tract 106, Atlantic County, New Jersey",0,19,5,90,101,89,247,711,677,1388,179,551,1849,44,8,2248,1609,221,730,52
34001010700,0.9277551020408163,0.07224489795918368,17,0.037142857142857144,2388,115,86,"Census Tract 107, Atlantic County, New Jersey",91,0,0,0,0,17,0,2019,254,2273,878,1486,5263,24,0,615,2450,177,2364,24
34001010800,0.9419680403700589,0.05803195962994113,280,0,835,181,43,"Census Tract 108, Atlantic County, New Jersey",0,57,6,71,29,92,25,754,366,1120,417,406,1997,0,12,973,1189,69,823,12
34001010900,0.9308176100628931,0.06918238993710692,494,0,1908,152,86,"Census Tract 109, Atlantic County, New Jersey",0,119,41,104,75,61,94,1537,683,2220,1025,778,4040,50,55,1544,2385,165,1803,105
34001011000,0.8528528528528528,0.14714714714714713,111,0,1014,40,7,"Census Tract 110, Atlantic County, New Jersey",0,34,6,6,29,14,22,692,160,852,375,582,1999,44,13,417,999,147,957,57
34001011100,0.8787593984962406,0.1212406015037594,230,0.009398496240601503,1148,128,55,"Census Tract 111, Atlantic County, New Jersey",10,8,0,31,0,33,158,655,280,935,387,623,1667,138,0,1022,1064,129,1010,138
34001011201,0.9656786271450858,0.0343213728549142,27,0,963,22,0,"Census Tract 112.01, Atlantic County, New Jersey",0,0,0,0,0,12,15,576,43,619,431,527,1638,0,5,123,641,22,958,5
34001011202,0.8584490348797833,0.14155096512021673,0,0.10768709786657636,3034,101,91,"Census Tract 112.02, Atlantic County, New Jersey",318,0,0,0,0,0,0,2124,411,2535,1053,1981,6104,0,0,1235,2953,418,3034,0
34001011300,0.9414951245937161,0.05850487540628386,612,0,1120,272,31,"Census Tract 113, Atlantic County, New Jersey",0,149,31,119,10,140,163,925,813,1738,476,464,2609,132,48,1789,1846,108,940,180
34001011401,0.9252842447211694,0.07471575527883054,55,0,1947,71,19,"Census Tract 114.01, Atlantic County, New Jersey",0,0,0,0,9,11,35,1490,219,1709,617,1222,3757,81,27,502,1847,138,1839,108
34001011403,0.90633608815427,0.09366391184573003,1508,0.0023612750885478157,794,113,40,"Census Tract 114.03, Atlantic County, New Jersey",6,672,172,39,272,150,203,1179,1124,2303,519,219,3138,0,56,2516,2541,238,738,56
34001011404,0.8987753061734567,0.10122469382654337,912,0.02999250187453137,1204,223,68,"Census Tract 114.04, Atlantic County, New Jersey",120,222,59,37,313,262,19,2761,835,3596,694,510,6775,0,0,2055,4001,405,1204,0
34001011500,0.93,0.07,250,0.034,1949,240,64,"Census Tract 115, Atlantic County, New Jersey",85,14,0,17,101,0,118,1794,531,2325,1071,864,5036,14,0,1769,2500,175,1935,14
34001011600,0.9184160305343512,0.08158396946564886,50,0.19751908396946566,1891,51,8,"Census Tract 116, Atlantic County, New Jersey",414,16,0,5,0,21,8,1734,191,1925,918,966,4322,0,7,622,2096,171,1884,7
34001011701,0.8324192565508836,0.1675807434491164,474,0.15722120658135283,2057,42,79,"Census Tract 117.01, Atlantic County, New Jersey",516,109,28,42,50,245,0,2275,457,2732,1246,623,7358,188,0,1504,3282,550,1869,188
34001011702,0.9186676994577847,0.08133230054221534,195,0.3718048024786987,1071,138,17,"Census Tract 117.02, Atlantic County, New Jersey",480,6,41,0,72,24,52,897,289,1186,588,473,2389,0,10,777,1291,105,1061,10
34001011802,0.9276075857038658,0.0723924142961342,287,0.03792851932895697,3732,0,2,"Census Tract 118.02, Atlantic County, New Jersey",208,0,0,155,22,0,110,4858,229,5087,1721,1944,15585,0,67,971,5484,397,3665,67
34001011803,0.9211281070745698,0.0788718929254302,842,0.06453154875717017,1294,180,46,"Census Tract 118.03, Atlantic County, New Jersey",135,265,124,24,217,125,87,1362,565,1927,856,296,3249,118,24,1372,2092,165,1152,142
34001011804,0.8953399541634836,0.10466004583651642,58,0.08861726508785332,2478,0,24,"Census Tract 118.04, Atlantic County, New Jersey",232,0,0,0,0,27,31,2162,182,2344,1131,1273,6257,74,0,595,2618,274,2404,74
34001011805,0.8823529411764706,0.11764705882352941,18,0.15606242496998798,819,19,0,"Census Tract 118.05, Atlantic County, New Jersey",130,0,0,0,0,0,18,674,61,735,491,323,1774,0,5,225,833,98,814,5
34001011900,0.8722480620155039,0.12775193798449613,1709,0,1889,435,278,"Census Tract 119, Atlantic County, New Jersey",0,746,283,50,172,210,248,1033,1780,2813,623,703,3431,517,46,4975,3225,412,1326,563
34001012000,0.8657205240174672,0.13427947598253276,631,0,867,280,208,"Census Tract 120, Atlantic County, New Jersey",0,69,31,105,111,188,127,942,644,1586,337,463,2975,37,30,1549,1832,246,800,67
34001012100,0.8025793650793651,0.1974206349206349,272,0,393,172,185,"Census Tract 121, Atlantic County, New Jersey",0,97,41,0,57,38,39,442,367,809,93,291,1335,9,0,1307,1008,199,384,9
34001012200,0.9059656218402427,0.09403437815975733,697,0,1305,368,348,"Census Tract 122, Atlantic County, New Jersey",0,12,63,206,108,31,277,1027,765,1792,493,792,3361,11,9,1858,1978,186,1285,20
34001012302,0.9081125827814569,0.09188741721854304,92,0.013245033112582781,1431,11,22,"Census Tract 123.02, Atlantic County, New Jersey",16,11,0,0,40,12,29,941,156,1097,858,573,2958,0,0,544,1208,111,1431,0
34001012401,0.8891992551210428,0.11080074487895716,98,0,1310,42,31,"Census Tract 124.01, Atlantic County, New Jersey",0,0,79,0,0,7,12,901,54,955,609,684,2627,17,0,144,1074,119,1293,17
34001012402,0.948905109489051,0.051094890510948905,5,0.004866180048661801,789,26,4,"Census Tract 124.02, Atlantic County, New Jersey",4,0,0,0,0,5,0,731,49,780,360,409,1792,20,0,114,822,42,769,20
34001012501,0.9332003988035892,0.06679960119641076,242,0,978,131,11,"Census Tract 125.01, Atlantic County, New Jersey",0,39,6,88,32,37,40,732,204,936,371,591,1947,11,5,485,1003,67,962,16
34001012502,0.9133986928104575,0.08660130718954248,66,0.011437908496732025,646,14,0,"Census Tract 125.02, Atlantic County, New Jersey",7,0,0,0,5,30,31,474,85,559,324,309,1241,0,13,229,612,53,633,13
34001012602,0.9417293233082706,0.05827067669172932,0,0,680,5,0,"Census Tract 126.02, Atlantic County, New Jersey",0,0,0,0,0,0,0,470,31,501,278,402,1284,0,0,119,532,31,680,0
34001012701,0.9040469973890339,0.09595300261096605,490,0,1010,111,87,"Census Tract 127.01, Atlantic County, New Jersey",0,243,11,11,61,21,143,812,573,1385,414,514,1879,73,9,1366,1532,147,928,82
34001012702,0.8229284903518729,0.17707150964812712,359,0,411,116,19,"Census Tract 127.02, Atlantic County, New Jersey",0,157,8,43,46,76,29,399,326,725,180,154,1008,39,38,806,881,156,334,77
34001012801,0.8118466898954704,0.18815331010452963,1072,0.007466401194624191,1279,144,94,"Census Tract 128.01, Atlantic County, New Jersey",15,521,199,104,71,90,87,815,816,1631,700,324,2059,228,27,1772,2009,378,1024,255
34001012802,0.6456266907123535,0.35437330928764654,238,0,588,18,8,"Census Tract 128.02, Atlantic County, New Jersey",0,56,4,4,97,46,31,566,150,716,279,285,1242,20,4,313,1109,393,564,24
34001013000,0.509409474367294,0.49059052563270605,306,0,1605,122,17,"Census Tract 130, Atlantic County, New Jersey",0,44,32,46,29,31,124,1375,195,1570,699,866,2883,9,31,356,3082,1512,1565,40
34001013101,0.44937238493723847,0.5506276150627615,26,0,603,54,24,"Census Tract 131.01, Atlantic County, New Jersey",0,8,0,10,0,8,0,519,18,537,273,314,1091,16,0,33,1195,658,587,16
34001013102,0.3260944501895898,0.6739055498104102,2032,0,435,49,5,"Census Tract 131.02, Atlantic County, New Jersey",0,228,217,771,161,200,455,612,334,946,209,188,1145,22,16,563,2901,1955,397,38
34001013201,0.5088517956499747,0.49114820435002526,1301,0,457,238,331,"Census Tract 132.01, Atlantic County, New Jersey",0,57,25,650,62,106,401,600,406,1006,265,131,1510,61,0,1515,1977,971,396,61
34001013202,0.6958904109589041,0.3041095890410959,537,0,661,115,63,"Census Tract 132.02, Atlantic County, New Jersey",0,125,88,79,58,23,164,710,306,1016,312,318,1809,31,0,638,1460,444,630,31
34001013301,0.48560986751941526,0.5143901324805847,811,0,707,259,174,"Census Tract 133.01, Atlantic County, New Jersey",0,0,50,160,63,125,413,566,497,1063,282,344,1128,73,8,901,2189,1126,626,81
34001013302,0.5668367346938775,0.4331632653061224,734,0,671,93,262,"Census Tract 133.02, Atlantic County, New Jersey",0,26,29,168,92,17,402,735,376,1111,204,467,1658,0,0,1061,1960,849,671,0
34001013500,0.44420226678291197,0.555797733217088,469,0.0034873583260680036,825,28,24,"Census Tract 135, Atlantic County, New Jersey",8,35,96,239,38,18,43,882,137,1019,403,350,2108,0,72,279,2294,1275,753,72
34001983400,1,0,0,0,8,0,67,"Census Tract 9834, Atlantic County, New Jersey",0,0,0,0,0,0,0,12,0,12,0,8,35,0,0,0,12,0,8,0
34001990000,NaN,NaN,0,NaN,0,0,0,"Census Tract 9900, Atlantic County, New Jersey",0,0,0,0,0,0,0,0,0,0,0,0,0,0,0,0,0,0,0,0
34003001000,0.9379941739492301,0.062005826050769874,256,0,2481,104,541,"Census Tract 10, Bergen County, New Jersey",0,0,18,89,21,17,111,1925,329,2254,1619,821,6105,41,0,559,2403,149,2440,41
34003002100,0.8764607679465777,0.12353923205342238,21,0,577,21,49,"Census Tract 21, Bergen County, New Jersey",0,0,0,0,14,7,0,430,95,525,255,273,1211,42,7,302,599,74,528,49
34003002200,0.9640171858216972,0.0359828141783029,185,5.370569280343716e-4,1945,31,71,"Census Tract 22, Bergen County, New Jersey",1,0,18,23,0,54,90,1549,246,1795,1053,863,4315,18,11,726,1862,67,1916,29
34003002300,0.9726402188782489,0.027359781121751026,410,0.006839945280437756,2008,84,218,"Census Tract 23, Bergen County, New Jersey",15,28,0,208,0,82,92,1732,401,2133,1108,816,4735,22,62,877,2193,60,1924,84
34003003100,0.9612756264236902,0.0387243735763098,312,0,1816,112,382,"Census Tract 31, Bergen County, New Jersey",0,19,6,36,7,82,162,1393,295,1688,998,795,4328,16,7,820,1756,68,1793,23
34003003200,0.981100611450806,0.018899388549193995,1035,0,949,164,419,"Census Tract 32, Bergen County, New Jersey",0,169,113,84,212,96,361,780,985,1765,272,507,2788,126,44,2207,1799,34,779,170
34003003300,1,0,411,0,2442,89,634,"Census Tract 33, Bergen County, New Jersey",0,0,0,0,0,41,370,1652,464,2116,1472,932,5440,38,0,1265,2116,0,2404,38
34003003401,0.8875453446191052,0.1124546553808948,47,0,977,23,227,"Census Tract 34.01, Bergen County, New Jersey",0,0,0,5,0,0,42,661,73,734,541,436,2570,0,0,213,827,93,977,0
34003003402,0.9736575481256332,0.02634245187436677,54,0,1102,51,198,"Census Tract 34.02, Bergen County, New Jersey",0,0,0,0,3,0,51,857,104,961,457,639,3313,0,6,365,987,26,1096,6
34003003500,0.9803407601572739,0.019659239842726082,887,0,795,346,285,"Census Tract 35, Bergen County, New Jersey",0,27,29,217,40,173,401,549,947,1496,178,469,1851,85,63,2151,1526,30,647,148
34003004001,0.9493891797556719,0.0506108202443281,410,0.009598603839441536,792,26,291,"Census Tract 40.01, Bergen County, New Jersey",11,22,0,11,47,11,319,738,350,1088,305,325,2444,162,0,889,1146,58,630,162
34003004002,0.9694656488549618,0.030534351145038167,513,0,1701,162,419,"Census Tract 40.02, Bergen County, New Jersey",0,96,65,24,63,75,190,1271,507,1778,874,709,3964,100,18,1033,1834,56,1583,118
34003005000,0.9141394249704609,0.08586057502953919,1288,0,2100,87,396,"Census Tract 50, Bergen County, New Jersey",0,0,0,0,73,185,1030,1500,821,2321,646,1285,4329,51,118,1862,2539,218,1931,169
34003006100,0.937854994988306,0.062145005011693955,2189,0,2184,669,1058,"Census Tract 61, Bergen County, New Jersey",0,268,240,370,104,573,634,1227,1580,2807,394,1280,2928,259,251,3762,2993,186,1674,510
34003006201,0.9408775981524249,0.05912240184757506,1554,0,896,606,595,"Census Tract 62.01, Bergen County, New Jersey",0,245,161,556,0,57,535,702,1335,2037,281,303,1379,256,56,2848,2165,128,584,312
34003006202,0.9060751398880895,0.09392486011191047,2130,0,1147,290,736,"Census Tract 62.02, Bergen County, New Jersey",0,54,49,1536,94,146,251,1631,636,2267,689,458,3907,0,0,1237,2502,235,1147,0
34003006300,0.9406593406593406,0.05934065934065934,2706,0,1813,496,1670,"Census Tract 63, Bergen County, New Jersey",0,289,167,446,278,480,1046,1407,2017,3424,1009,642,3868,102,60,4949,3640,216,1651,162
34003007001,0.9654395191585274,0.03456048084147258,178,0,1303,26,302,"Census Tract 70.01, Bergen County, New Jersey",0,18,0,0,55,7,98,993,292,1285,556,701,3012,13,33,811,1331,46,1257,46
34003007002,0.9560439560439561,0.04395604395604396,106,0,1599,37,113,"Census Tract 70.02, Bergen County, New Jersey",0,0,0,15,5,39,47,1302,177,1479,846,753,4047,0,0,640,1547,68,1599,0
34003008000,0.9466098919095971,0.053390108090402885,407,0,2301,81,562,"Census Tract 80, Bergen County, New Jersey",0,39,41,184,75,35,33,2408,482,2890,1168,1119,7350,0,14,1313,3053,163,2287,14
34003009100,0.9445378151260504,0.05546218487394958,38,0,1698,9,230,"Census Tract 91, Bergen County, New Jersey",0,0,0,0,0,23,15,1507,179,1686,933,765,4247,0,0,696,1785,99,1698,0
34003009200,0.9754385964912281,0.02456140350877193,6,0,1598,0,283,"Census Tract 92, Bergen County, New Jersey",0,0,0,0,0,0,6,1052,60,1112,904,694,3200,0,0,211,1140,28,1598,0
34003010100,0.9674479166666666,0.032552083333333336,371,0,2365,84,260,"Census Tract 101, Bergen County, New Jersey",0,24,80,0,67,121,79,1803,426,2229,982,1349,5045,34,0,833,2304,75,2331,34
34003010200,0.9571596244131455,0.04284037558685446,837,0,1061,159,264,"Census Tract 102, Bergen County, New Jersey",0,183,181,18,163,90,202,748,883,1631,381,569,2499,54,57,1951,1704,73,950,111
34003010300,0.9468726450640542,0.05312735493594574,518,0,3199,204,376,"Census Tract 103, Bergen County, New Jersey",0,94,47,71,26,0,280,2026,487,2513,1444,1627,6439,112,16,910,2654,141,3071,128
34003011100,0.9429928741092637,0.057007125890736345,700,0,883,196,290,"Census Tract 111, Bergen County, New Jersey",0,49,46,58,64,211,272,939,649,1588,269,314,2581,88,212,1795,1684,96,583,300
34003011200,1,0,938,0,1155,102,91,"Census Tract 112, Bergen County, New Jersey",0,15,13,46,74,302,488,765,968,1733,370,679,2159,27,79,2837,1733,0,1049,106
34003011300,0.9211563731931669,0.07884362680683311,378,0,1114,15,128,"Census Tract 113, Bergen County, New Jersey",0,8,30,7,0,18,315,978,424,1402,429,664,3009,21,0,1313,1522,120,1093,21
34003011400,0.9252775405636209,0.07472245943637916,1315,0,2159,73,188,"Census Tract 114, Bergen County, New Jersey",0,0,90,36,46,83,1060,1176,991,2167,820,723,3231,409,207,3156,2342,175,1543,616
34003012001,0.9126031507876969,0.08739684921230308,2281,0,1455,404,346,"Census Tract 120.01, Bergen County, New Jersey",0,211,203,512,119,209,1027,708,1725,2433,243,934,1918,146,132,4245,2666,233,1177,278
34003012002,0.9343814080656186,0.06561859193438141,907,0,1120,158,264,"Census Tract 120.02, Bergen County, New Jersey",0,59,24,69,39,235,481,672,695,1367,390,428,1594,222,80,1691,1463,96,818,302
34003013001,0.8756641870350691,0.12433581296493093,3481,0,254,355,1854,"Census Tract 130.01, Bergen County, New Jersey",0,478,602,2085,126,116,74,888,2408,3296,146,61,1976,14,33,4693,3764,468,207,47
34003013002,0.9555382215288611,0.044461778471138844,1870,0,819,264,996,"Census Tract 130.02, Bergen County, New Jersey",0,127,322,658,171,269,323,1003,1447,2450,437,160,2001,75,147,3509,2564,114,597,222
34003014000,0.9525436598329536,0.04745634016704632,327,0.006074411541381929,2596,101,419,"Census Tract 140, Bergen County, New Jersey",16,51,62,34,0,71,109,2087,422,2509,1181,1353,6147,0,62,1221,2634,125,2534,62
34003015100,0.9440628066732091,0.05593719332679097,325,0.015701668302257114,836,28,134,"Census Tract 151, Bergen County, New Jersey",16,33,75,113,9,33,62,765,197,962,542,241,2352,47,6,477,1019,57,783,53
34003015200,0.9375487900078064,0.0624512099921936,1114,0,1973,184,687,"Census Tract 152, Bergen County, New Jersey",0,321,26,0,252,170,345,1387,1015,2402,1009,805,3972,74,85,2231,2562,160,1814,159
34003015300,0.8827080638206123,0.11729193617938767,1087,0.0021561017680034496,2254,454,701,"Census Tract 153, Bergen County, New Jersey",5,33,85,65,205,307,392,1126,921,2047,457,1288,3573,69,440,2347,2319,272,1745,509
34003015400,0.8344066237350506,0.1655933762649494,2519,0,2036,409,611,"Census Tract 154, Bergen County, New Jersey",0,145,282,1252,161,240,439,721,2000,2721,702,754,2396,222,358,4528,3261,540,1456,580
34003015500,0.9710536472404477,0.028946352759552298,1160,0,1587,273,780,"Census Tract 155, Bergen County, New Jersey",0,65,106,140,493,169,187,1627,889,2516,686,733,4285,140,28,1984,2591,75,1419,168
34003016000,0.8998482549317147,0.10015174506828528,51,0,1590,43,398,"Census Tract 160, Bergen County, New Jersey",0,0,0,11,15,7,18,1538,241,1779,359,1197,4526,34,0,788,1977,198,1556,34
34003017100,0.9541697971450037,0.04583020285499624,563,0,2775,223,816,"Census Tract 171, Bergen County, New Jersey",0,61,14,28,89,299,72,2039,501,2540,1423,1174,5901,164,14,1137,2662,122,2597,178
34003017200,0.9289281598155974,0.07107184018440262,1155,0,1818,253,444,"Census Tract 172, Bergen County, New Jersey",0,260,74,136,148,221,316,1244,1174,2418,841,903,3846,14,60,2304,2603,185,1744,74
34003017300,0.9528487229862476,0.047151277013752456,105,0,2298,27,439,"Census Tract 173, Bergen County, New Jersey",0,13,0,0,0,0,92,1791,149,1940,991,1307,5378,0,0,618,2036,96,2298,0
34003017400,0.9956116291826659,0.004388370817334065,115,0,1974,85,554,"Census Tract 174, Bergen County, New Jersey",0,38,8,33,9,0,27,1619,196,1815,947,949,4858,8,70,458,1823,8,1896,78
34003017500,0.9892086330935251,0.01079136690647482,245,0.006834532374100719,3055,128,482,"Census Tract 175, Bergen County, New Jersey",19,13,0,0,37,86,109,2485,265,2750,1364,1614,7468,0,77,909,2780,30,2978,77
34003018100,0.940959409594096,0.05904059040590406,2293,0,1300,904,1276,"Census Tract 181, Bergen County, New Jersey",0,66,142,327,248,714,796,932,1873,2805,473,448,3008,318,61,4409,2981,176,921,379
34003018200,0.9553340716131414,0.04466592838685862,1987,0,1423,379,499,"Census Tract 182, Bergen County, New Jersey",0,187,252,107,92,518,831,892,1696,2588,541,549,2681,267,66,4163,2709,121,1090,333
34003019102,0.9701492537313433,0.029850746268656716,1261,0,519,133,494,"Census Tract 191.02, Bergen County, New Jersey",0,51,231,769,46,35,129,708,722,1430,307,176,1444,16,20,1893,1474,44,483,36
34003019103,0.9400337837837838,0.059966216216216214,1998,0.005489864864864865,326,293,670,"Census Tract 191.03, Bergen County, New Jersey",13,29,1054,707,48,54,106,1010,1216,2226,105,178,1627,26,17,2605,2368,142,283,43
34003019104,0.9635119726339795,0.036488027366020526,1309,0.009122006841505131,829,222,421,"Census Tract 191.04, Bergen County, New Jersey",16,75,213,735,64,79,143,1014,676,1690,253,445,2295,67,64,1659,1754,64,698,131
34003019202,0.8533077660594439,0.14669223394055608,867,0,175,125,293,"Census Tract 192.02, Bergen County, New Jersey",0,61,171,475,37,69,54,205,685,890,41,33,503,69,32,1610,1043,153,74,101
34003019203,0.9029892836999436,0.09701071630005641,1631,0.006204173716864072,866,272,311,"Census Tract 192.03, Bergen County, New Jersey",11,52,33,1421,25,43,57,1070,531,1601,442,343,2095,10,71,904,1773,172,785,81
34003019204,0.9466594827586207,0.05334051724137931,1483,0,676,326,429,"Census Tract 192.04, Bergen County, New Jersey",0,39,101,1092,27,46,178,934,823,1757,302,304,2047,34,36,1506,1856,99,606,70
34003019303,0.9648549243972211,0.035145075602778915,1989,0,952,314,682,"Census Tract 193.03, Bergen County, New Jersey",0,142,125,693,385,190,454,947,1414,2361,295,373,2369,196,88,3205,2447,86,668,284
34003019304,0.9581545064377682,0.04184549356223176,303,0.018240343347639486,967,38,343,"Census Tract 193.04, Bergen County, New Jersey",17,0,2,0,10,43,248,610,283,893,309,584,1831,11,63,852,932,39,893,74
34003019305,0.8374459425082676,0.16255405749173238,3233,0,1692,222,956,"Census Tract 193.05, Bergen County, New Jersey",0,148,248,2801,0,0,36,2747,545,3292,777,915,4979,0,0,1537,3931,639,1692,0
34003019306,0.9085173501577287,0.0914826498422713,558,0,478,60,259,"Census Tract 193.06, Bergen County, New Jersey",0,19,15,366,0,79,79,687,177,864,187,252,1659,12,27,358,951,87,439,39
34003020100,0.9524390243902439,0.0475609756097561,340,0,1393,11,99,"Census Tract 201, Bergen County, New Jersey",0,80,50,65,60,63,22,1148,414,1562,572,784,3287,37,0,773,1640,78,1356,37
34003020200,0.9564459930313589,0.04355400696864112,95,0,2682,14,214,"Census Tract 202, Bergen County, New Jersey",0,13,0,0,0,43,39,2157,39,2196,1559,1123,6646,0,0,172,2296,100,2682,0
34003021100,0.9464619992512168,0.053538000748783225,1930,0.013478098090602771,1682,194,280,"Census Tract 211, Bergen County, New Jersey",36,31,59,35,209,256,1340,1010,1518,2528,530,850,2870,169,133,3864,2671,143,1380,302
34003021200,0.9650675360968793,0.03493246390312063,1657,0,1462,187,199,"Census Tract 212, Bergen County, New Jersey",0,40,0,23,141,309,1144,905,1167,2072,498,507,2517,326,131,3189,2147,75,1005,457
34003021300,0.901270207852194,0.098729792147806,1106,0,1317,176,154,"Census Tract 213, Bergen County, New Jersey",0,83,0,0,0,140,883,794,767,1561,212,759,2457,160,186,1980,1732,171,971,346
34003021400,0.916010498687664,0.08398950131233596,1323,0,1070,124,215,"Census Tract 214, Bergen County, New Jersey",0,76,40,87,65,224,831,653,1092,1745,126,721,2020,183,40,2992,1905,160,847,223
34003021500,0.9364102564102564,0.06358974358974359,1586,0.008717948717948718,1212,343,324,"Census Tract 215, Bergen County, New Jersey",17,64,6,85,134,204,1093,509,1317,1826,427,459,1432,284,42,3655,1950,124,886,326
34003021600,0.9117990654205608,0.08820093457943926,1462,0,732,265,221,"Census Tract 216, Bergen County, New Jersey",0,5,27,36,191,221,982,442,1119,1561,299,274,1200,55,104,3356,1712,151,573,159
34003022100,0.9393511988716502,0.06064880112834979,115,0,1375,60,439,"Census Tract 221, Bergen County, New Jersey",0,0,23,68,0,0,24,1215,117,1332,786,556,3690,8,25,206,1418,86,1342,33
34003022200,0.9760860900757273,0.023913909924272617,46,0,3054,90,879,"Census Tract 222, Bergen County, New Jersey",0,0,13,0,0,24,9,2371,78,2449,1522,1504,7725,0,28,185,2509,60,3026,28
34003023100,0.9371761658031088,0.06282383419689119,1391,0.019430051813471502,169,470,366,"Census Tract 231, Bergen County, New Jersey",30,125,230,623,169,101,143,84,1363,1447,16,0,191,128,25,2946,1544,97,16,153
34003023200,0.9619274241522903,0.0380725758477097,2460,0,1106,227,832,"Census Tract 232, Bergen County, New Jersey",0,292,647,824,170,284,243,1438,1796,3234,391,543,3102,97,75,3526,3362,128,934,172
34003023301,0.9764373232799246,0.0235626767200754,109,0,1037,40,234,"Census Tract 233.01, Bergen County, New Jersey",0,55,35,0,0,0,19,918,118,1036,492,530,2489,15,0,473,1061,25,1022,15
34003023302,0.902127659574468,0.09787234042553192,2769,0,947,333,712,"Census Tract 233.02, Bergen County, New Jersey",0,192,364,1882,138,31,162,917,1839,2756,504,194,1869,190,59,3545,3055,299,698,249
34003023401,0.9138755980861244,0.0861244019138756,1732,0,468,291,486,"Census Tract 234.01, Bergen County, New Jersey",0,200,122,696,235,284,195,315,1404,1719,62,55,511,273,78,3361,1881,162,117,351
34003023402,0.9291828793774319,0.07081712062256809,1866,0,939,460,641,"Census Tract 234.02, Bergen County, New Jersey",0,99,569,524,325,8,341,732,1656,2388,440,398,2359,49,52,3434,2570,182,838,101
34003023501,0.9327789327789328,0.06722106722106722,1038,0,709,262,481,"Census Tract 235.01, Bergen County, New Jersey",0,136,154,166,107,169,306,439,907,1346,275,159,1426,194,81,2084,1443,97,434,275
34003023502,0.9106239460370995,0.0893760539629005,2233,0.012647554806070826,572,411,482,"Census Tract 235.02, Bergen County, New Jersey",30,394,375,1100,133,91,140,649,1511,2160,248,76,1247,227,21,3512,2372,212,324,248
34003023601,0.8952451708766717,0.10475482912332838,968,0,567,179,217,"Census Tract 236.01, Bergen County, New Jersey",0,80,25,74,64,231,494,424,781,1205,160,231,857,169,7,1874,1346,141,391,176
34003023602,0.8995006242197253,0.10049937578027465,1357,0.004369538077403246,532,454,224,"Census Tract 236.02, Bergen County, New Jersey",7,149,200,91,114,217,586,354,1087,1441,89,242,1215,201,0,2983,1602,161,331,201
34003024100,0.9731285988483686,0.026871401151631478,121,0,2776,66,246,"Census Tract 241, Bergen County, New Jersey",0,0,8,39,21,35,18,1783,245,2028,1581,1100,5263,73,22,660,2084,56,2681,95
34003024200,1,0,136,0,1817,34,236,"Census Tract 242, Bergen County, New Jersey",0,0,18,44,22,8,44,1489,136,1625,895,872,4343,50,0,413,1625,0,1767,50
34003025100,0.9839051249470563,0.01609487505294367,959,0.019483269800931808,1668,226,324,"Census Tract 251, Bergen County, New Jersey",46,61,103,149,25,274,347,1138,1185,2323,612,880,3511,148,28,2909,2361,38,1492,176
34003025200,0.9382957884427032,0.061704211557296766,373,0,1881,182,406,"Census Tract 252, Bergen County, New Jersey",0,0,59,51,17,23,223,1604,312,1916,596,1190,4861,78,17,790,2042,126,1786,95
34003026100,0.9939722724532851,0.006027727546714889,205,0.004822182037371911,1905,115,221,"Census Tract 261, Bergen County, New Jersey",8,0,0,132,0,0,73,1369,280,1649,881,954,4134,61,9,478,1659,10,1835,70
34003026200,0.9735792622133599,0.02642073778664008,244,0,2258,57,461,"Census Tract 262, Bergen County, New Jersey",0,104,0,20,52,24,44,1723,230,1953,946,1169,5143,143,0,602,2006,53,2115,143
34003027000,0.9445927903871829,0.05540720961281709,32,0,1514,31,463,"Census Tract 270, Bergen County, New Jersey",0,0,0,0,0,5,27,1340,75,1415,811,703,3837,0,0,259,1498,83,1514,0
34003028001,0.9519801980198019,0.04801980198019802,840,0,1237,99,483,"Census Tract 280.01, Bergen County, New Jersey",0,76,196,31,199,188,150,1069,854,1923,534,559,3020,102,42,2278,2020,97,1093,144
34003028002,0.9567275185936444,0.043272481406355645,415,0.016903313049357674,1359,132,321,"Census Tract 280.02, Bergen County, New Jersey",25,23,106,129,0,51,106,920,495,1415,654,570,2742,135,0,1057,1479,64,1224,135
34003029100,0.9432938856015779,0.05670611439842209,1442,0.0039447731755424065,756,205,519,"Census Tract 291, Bergen County, New Jersey",8,304,307,138,285,131,277,554,1359,1913,287,172,1431,165,132,3009,2028,115,459,297
34003029200,0.8956619296933434,0.10433807030665669,1467,0.012341062079281975,1853,94,361,"Census Tract 292, Bergen County, New Jersey",33,227,238,90,35,208,669,1177,1218,2395,564,1030,3621,158,101,2757,2674,279,1594,259
34003030100,0.9946550048590865,0.005344995140913508,1422,0.0228377065111759,1580,85,225,"Census Tract 301, Bergen County, New Jersey",47,79,219,123,49,221,731,779,1268,2047,647,469,2318,403,61,3225,2058,11,1116,464
34003030200,0.9540960451977402,0.04590395480225989,1904,0.003884180790960452,1841,332,411,"Census Tract 302, Bergen County, New Jersey",11,100,209,48,145,381,1021,1193,1509,2702,589,798,3555,314,140,3614,2832,130,1387,454
34003030300,0.9219035997559487,0.07809640024405125,1226,0,948,134,187,"Census Tract 303, Bergen County, New Jersey",0,107,80,50,42,157,790,564,947,1511,321,446,1689,142,39,2761,1639,128,767,181
34003030400,0.9344779257182901,0.06552207428170988,2172,0,2257,289,290,"Census Tract 304, Bergen County, New Jersey",0,14,30,0,62,806,1260,1093,1574,2667,565,1207,3558,302,183,3654,2854,187,1772,485
34003031100,0.9543681747269891,0.04563182527301092,1857,0,1770,85,677,"Census Tract 311, Bergen County, New Jersey",0,55,131,417,35,152,1067,1224,1223,2447,837,766,3543,86,81,2678,2564,117,1603,167
34003031200,0.9686028257456829,0.03139717425431711,973,0,1542,241,297,"Census Tract 312, Bergen County, New Jersey",0,33,114,110,66,133,517,900,951,1851,742,647,2662,137,16,2057,1911,60,1389,153
34003031300,0.9120728929384966,0.08792710706150342,1146,0.027790432801822324,1767,203,309,"Census Tract 313, Bergen County, New Jersey",61,100,13,187,19,241,586,1265,737,2002,513,967,3513,185,102,1634,2195,193,1480,287
34003031400,0.9452780229479258,0.05472197705207414,1285,0,1962,77,414,"Census Tract 314, Bergen County, New Jersey",0,55,42,0,33,95,1060,1229,913,2142,863,940,3703,90,69,2219,2266,124,1803,159
34003032102,1,0,153,0.0461465271170314,2387,129,183,"Census Tract 321.02, Bergen County, New Jersey",97,0,26,55,17,13,42,1916,186,2102,1616,713,5427,58,0,469,2102,0,2329,58
34003032103,0.9894949494949495,0.010505050505050505,1455,0,993,40,148,"Census Tract 321.03, Bergen County, New Jersey",0,651,54,26,446,195,83,1788,661,2449,819,161,3621,13,0,1528,2475,26,980,13
34003032104,0.9790794979079498,0.02092050209205021,125,0,857,18,69,"Census Tract 321.04, Bergen County, New Jersey",0,0,0,0,35,13,77,563,139,702,529,321,1650,6,1,506,717,15,850,7
34003032201,0.9771453212591634,0.02285467874083657,688,0,1838,75,200,"Census Tract 322.01, Bergen County, New Jersey",0,187,34,87,165,63,152,1825,441,2266,942,857,4747,39,0,983,2319,53,1799,39
34003032202,0.9836552748885586,0.01634472511144131,544,0,1432,89,75,"Census Tract 322.02, Bergen County, New Jersey",0,44,76,76,75,80,193,1423,563,1986,767,614,3826,16,35,1151,2019,33,1381,51
34003033100,0.9485842026825634,0.05141579731743666,189,0,1384,90,124,"Census Tract 331, Bergen County, New Jersey",0,26,0,0,0,0,163,1040,233,1273,650,664,2953,70,0,838,1342,69,1314,70
34003033200,0.9341383095499451,0.06586169045005488,264,0,1021,72,126,"Census Tract 332, Bergen County, New Jersey",0,29,5,7,11,46,166,564,287,851,462,489,1686,23,47,698,911,60,951,70
34003033300,0.9800427655024947,0.019957234497505347,769,0,1018,196,191,"Census Tract 333, Bergen County, New Jersey",0,50,19,216,85,301,98,597,778,1375,543,276,1750,120,79,1706,1403,28,819,199
34003034000,0.9500182415176943,0.04998175848230573,870,0,2799,169,283,"Census Tract 340, Bergen County, New Jersey",0,74,82,202,32,100,380,1809,795,2604,1631,867,5356,251,50,1894,2741,137,2498,301
34003035100,0.9927058006252171,0.007294199374782911,485,0,3052,115,531,"Census Tract 351, Bergen County, New Jersey",0,137,0,18,110,159,61,2401,457,2858,1628,1372,7161,45,7,1269,2879,21,3000,52
34003035200,0.9780915287244402,0.021908471275559883,181,0,2266,65,296,"Census Tract 352, Bergen County, New Jersey",0,53,20,34,20,36,18,1790,219,2009,1370,858,5302,18,20,407,2054,45,2228,38
34003036100,0.9539325842696629,0.046067415730337076,547,0,729,67,150,"Census Tract 361, Bergen County, New Jersey",0,36,12,0,19,54,426,411,438,849,31,549,1341,61,88,1346,890,41,580,149
34003036200,0.9208294062205467,0.07917059377945335,73,0.3072573044297832,870,99,159,"Census Tract 362, Bergen County, New Jersey",326,0,0,0,4,21,48,779,198,977,286,504,2202,68,12,537,1061,84,790,80
34003037100,0.9387533875338754,0.06124661246612466,321,0,2756,15,358,"Census Tract 371, Bergen County, New Jersey",0,7,0,44,18,76,176,1457,275,1732,1757,901,4801,73,25,832,1845,113,2658,98
34003037201,0.9712062256809338,0.028793774319066146,31,0,1329,94,275,"Census Tract 372.01, Bergen County, New Jersey",0,7,0,0,0,0,24,1229,19,1248,617,698,3797,0,14,44,1285,37,1315,14
34003037202,0.9802289281997919,0.019771071800208116,1832,0,2129,122,376,"Census Tract 372.02, Bergen County, New Jersey",0,109,24,162,229,1136,172,951,1875,2826,530,1034,3026,361,204,3854,2883,57,1564,565
34003038100,0.9829351535836177,0.017064846416382253,1375,0,1532,190,484,"Census Tract 381, Bergen County, New Jersey",0,194,19,45,92,309,716,1014,1290,2304,783,492,2857,98,159,2756,2344,40,1275,257
34003038200,0.951408061844285,0.048591938155715074,1227,0,1097,164,309,"Census Tract 382, Bergen County, New Jersey",0,284,49,18,97,464,315,607,1116,1723,285,583,1786,115,114,2414,1811,88,868,229
34003038300,0.9741228070175438,0.02587719298245614,867,0,2217,62,224,"Census Tract 383, Bergen County, New Jersey",0,16,0,0,0,99,752,1636,585,2221,940,942,4569,243,92,1317,2280,59,1882,335
34003039100,0.9256926952141058,0.0743073047858942,126,0,1362,33,122,"Census Tract 391, Bergen County, New Jersey",0,0,0,0,0,52,74,1166,304,1470,817,479,3454,26,40,712,1588,118,1296,66
34003039200,0.9701718907987866,0.029828109201213347,10,0,2651,31,136,"Census Tract 392, Bergen County, New Jersey",0,0,0,0,0,0,10,1837,82,1919,1549,1102,5692,0,0,278,1978,59,2651,0
34003039300,0.9331983805668016,0.06680161943319839,45,0,1439,28,53,"Census Tract 393, Bergen County, New Jersey",0,0,0,12,22,6,5,890,32,922,629,805,2604,5,0,60,988,66,1434,5
34003040001,0.9740034662045061,0.025996533795493933,20,0.00779896013864818,1193,19,262,"Census Tract 400.01, Bergen County, New Jersey",9,11,0,0,0,0,9,1068,56,1124,527,666,3192,0,0,210,1154,30,1193,0
34003040002,0.9912989434431324,0.00870105655686762,249,0,1544,37,416,"Census Tract 400.02, Bergen County, New Jersey",0,32,57,0,8,100,52,1325,270,1595,843,671,3860,7,23,708,1609,14,1514,30
34003041100,0.9530411449016101,0.046958855098389984,1637,0,849,673,730,"Census Tract 411, Bergen County, New Jersey",0,302,187,226,192,243,487,579,1552,2131,108,211,1616,496,34,4254,2236,105,319,530
34003041200,0.9870283018867925,0.012971698113207548,1144,0,738,305,471,"Census Tract 412, Bergen County, New Jersey",0,176,38,48,120,183,579,634,1040,1674,32,478,1718,212,16,2776,1696,22,510,228
34003041301,0.9625304136253041,0.037469586374695864,1453,0,863,354,607,"Census Tract 413.01, Bergen County, New Jersey",0,180,226,94,179,121,653,683,1295,1978,292,284,2080,190,97,3558,2055,77,576,287
34003041302,0.9355531686358755,0.0644468313641246,1411,0.004296455424274973,638,182,427,"Census Tract 413.02, Bergen County, New Jersey",8,127,210,225,59,162,628,729,1013,1742,235,360,1759,0,43,2783,1862,120,595,43
34003042100,0.958706661472536,0.04129333852746397,159,0,3318,160,429,"Census Tract 421, Bergen County, New Jersey",0,0,0,159,0,0,0,2220,241,2461,1257,1816,6610,194,51,706,2567,106,3073,245
34003042301,0.9520958083832335,0.04790419161676647,129,0,1810,149,292,"Census Tract 423.01, Bergen County, New Jersey",0,6,22,94,0,7,0,1140,291,1431,644,1152,3588,0,14,735,1503,72,1796,14
34003042302,0.9449728260869565,0.05502717391304348,60,0,2073,9,251,"Census Tract 423.02, Bergen County, New Jersey",0,0,25,0,0,0,35,1357,34,1391,1221,840,4236,0,12,128,1472,81,2061,12
34003042400,0.9618729096989966,0.03812709030100334,20,0,2045,47,262,"Census Tract 424, Bergen County, New Jersey",0,0,0,0,0,0,20,1369,69,1438,973,1072,4224,0,0,220,1495,57,2045,0
34003042500,0.9184971098265896,0.0815028901734104,493,0,1091,134,312,"Census Tract 425, Bergen County, New Jersey",0,16,38,127,0,101,211,1103,486,1589,450,641,3343,0,0,1197,1730,141,1091,0
34003043001,0.9524413443246671,0.04755865567533291,107,0,1394,39,219,"Census Tract 430.01, Bergen County, New Jersey",0,0,0,0,0,30,77,1389,113,1502,625,762,3774,7,0,388,1577,75,1387,7
34003043002,0.953315649867374,0.04668435013262599,711,0.010079575596816976,1448,146,238,"Census Tract 430.02, Bergen County, New Jersey",19,117,41,96,117,224,116,1230,567,1797,841,555,3401,8,44,958,1885,88,1396,52
34003044100,0.9765840220385675,0.023415977961432508,127,0,3079,31,448,"Census Tract 441, Bergen County, New Jersey",0,14,0,100,0,0,13,1960,167,2127,1846,1141,5934,78,14,310,2178,51,2987,92
34003044201,0.9682059046177138,0.03179409538228615,109,0,1424,19,274,"Census Tract 442.01, Bergen County, New Jersey",0,32,0,21,15,27,14,1165,114,1279,724,664,3484,36,0,258,1321,42,1388,36
34003044202,0.8872117400419287,0.11278825995807128,872,0,1342,82,206,"Census Tract 442.02, Bergen County, New Jersey",0,216,134,36,231,161,94,1673,443,2116,692,593,4014,57,0,902,2385,269,1285,57
34003045100,0.9769725702675246,0.02302742973247545,1676,0,1944,159,294,"Census Tract 451, Bergen County, New Jersey",0,65,0,103,34,288,1186,1369,1516,2885,936,802,4040,107,99,4280,2953,68,1738,206
34003045200,0.9054415700267618,0.09455842997323818,585,0,586,72,157,"Census Tract 452, Bergen County, New Jersey",0,115,45,51,140,72,162,523,492,1015,314,183,1688,26,63,1230,1121,106,497,89
34003046100,0.9873708381171068,0.012629161882893225,1179,0,1316,138,401,"Census Tract 461, Bergen County, New Jersey",0,103,235,129,19,153,540,825,895,1720,456,605,2568,176,79,1850,1742,22,1061,255
34003046200,0.8894009216589862,0.11059907834101383,548,0,1336,99,348,"Census Tract 462, Bergen County, New Jersey",0,32,51,0,10,16,439,987,364,1351,598,728,2886,0,10,1037,1519,168,1326,10
34003046300,0.9169831795984807,0.08301682040151927,1195,0.0027129679869777536,1393,195,451,"Census Tract 463, Bergen County, New Jersey",5,103,208,227,10,61,586,776,914,1690,586,297,2454,465,45,2132,1843,153,883,510
34003047100,0.9816607233825777,0.018339276617422313,120,0,2271,10,381,"Census Tract 471, Bergen County, New Jersey",0,14,45,0,6,14,41,1734,193,1927,1096,1109,5345,54,12,576,1963,36,2205,66
34003047200,0.9887798036465638,0.011220196353436185,164,0,1089,73,603,"Census Tract 472, Bergen County, New Jersey",0,10,0,113,14,0,27,1218,192,1410,665,405,4037,0,19,410,1426,16,1070,19
34003047300,0.978021978021978,0.02197802197802198,11,0,1097,5,293,"Census Tract 473, Bergen County, New Jersey",0,0,0,6,0,0,5,946,33,979,762,304,3088,31,0,78,1001,22,1066,31
34003047400,0.9502487562189055,0.04975124378109453,1133,0,1198,116,437,"Census Tract 474, Bergen County, New Jersey",0,119,183,25,124,257,425,883,1027,1910,574,335,2724,167,122,1952,2010,100,909,289
34003047500,0.9643672910004568,0.03563270899954317,185,0,2264,0,667,"Census Tract 475, Bergen County, New Jersey",0,0,25,52,0,35,73,1687,424,2111,1448,800,5391,0,16,1433,2189,78,2248,16
34003048100,0.937080024434942,0.06291997556505803,876,0.006108735491753207,729,52,449,"Census Tract 481, Bergen County, New Jersey",10,62,83,27,78,539,87,643,891,1534,355,251,1757,80,43,2120,1637,103,606,123
34003048200,0.973322554567502,0.02667744543249798,123,0,3219,0,681,"Census Tract 482, Bergen County, New Jersey",0,42,0,10,0,53,18,2302,106,2408,2102,1117,7328,0,0,313,2474,66,3219,0
34003049001,0.9749847467968273,0.025015253203172667,25,0.006101281269066504,1612,36,158,"Census Tract 490.01, Bergen County, New Jersey",10,0,0,0,16,0,9,1550,48,1598,946,642,4407,24,0,80,1639,41,1588,24
34003049002,0.9382537385431742,0.06174626145682586,413,0,1830,173,278,"Census Tract 490.02, Bergen County, New Jersey",0,10,14,239,16,113,21,1632,313,1945,831,967,4848,32,0,591,2073,128,1798,32
34003050000,0.9632672788786854,0.03673272112131464,624,0,2103,193,379,"Census Tract 500, Bergen County, New Jersey",0,88,39,152,0,139,206,1367,626,1993,1065,981,3850,14,43,1532,2069,76,2046,57
34003051100,0.9740680713128039,0.02593192868719611,1110,0,2108,95,652,"Census Tract 511, Bergen County, New Jersey",0,383,53,30,52,163,429,1516,888,2404,891,967,4224,173,77,1677,2468,64,1858,250
34003051200,0.9386317907444668,0.0613682092555332,149,0,1118,12,229,"Census Tract 512, Bergen County, New Jersey",0,6,0,0,6,22,115,807,126,933,603,478,2323,0,37,254,994,61,1081,37
34003051300,0.937844611528822,0.06215538847117794,1263,0,970,192,701,"Census Tract 513, Bergen County, New Jersey",0,182,238,76,159,223,385,787,1084,1871,337,512,1946,90,31,2546,1995,124,849,121
34003051400,0.9885117493472585,0.011488250652741514,591,0,1989,104,644,"Census Tract 514, Bergen County, New Jersey",0,108,47,71,16,20,329,1363,530,1893,708,1169,3879,20,92,1305,1915,22,1877,112
34003052100,0.9804392587508579,0.01956074124914207,576,0,3015,107,277,"Census Tract 521, Bergen County, New Jersey",0,99,94,80,0,36,267,2271,586,2857,1288,1670,6232,57,0,1481,2914,57,2958,57
34003052200,0.9202049780380673,0.07979502196193265,1319,0.007320644216691069,1807,264,226,"Census Tract 522, Bergen County, New Jersey",20,93,132,309,22,189,574,1372,1142,2514,451,1124,3851,192,40,2334,2732,218,1575,232
34003053100,0.9279411764705883,0.07205882352941176,206,0,857,140,99,"Census Tract 531, Bergen County, New Jersey",0,0,9,163,34,0,0,1070,192,1262,408,449,2993,0,0,219,1360,98,857,0
34003053200,0.9463527595522964,0.05364724044770359,158,0,3180,55,358,"Census Tract 532, Bergen County, New Jersey",0,10,16,34,70,0,28,2185,267,2452,2290,867,7288,23,0,948,2591,139,3157,23
34003054100,0.9533548618586294,0.04664513814137065,381,0,2777,323,624,"Census Tract 541, Bergen County, New Jersey",0,0,0,16,59,133,173,2122,535,2657,1335,1376,6721,47,19,1595,2787,130,2711,66
34003054200,0.9632516703786191,0.036748329621380846,872,0,1078,229,473,"Census Tract 542, Bergen County, New Jersey",0,150,110,7,364,94,147,892,838,1730,294,514,2516,124,146,1978,1796,66,808,270
34003054300,0.9567120622568094,0.04328793774319066,64,0,2830,83,274,"Census Tract 543, Bergen County, New Jersey",0,51,0,0,0,0,13,1839,128,1967,1612,1196,6267,0,22,322,2056,89,2808,22
34003054400,0.9296254256526674,0.07037457434733257,728,0,1675,346,959,"Census Tract 544, Bergen County, New Jersey",0,119,0,231,118,151,109,1662,795,2457,996,601,5285,0,78,1792,2643,186,1597,78
34003054500,0.9718397997496871,0.028160200250312892,193,0.01376720901126408,1579,49,482,"Census Tract 545, Bergen County, New Jersey",22,8,29,6,115,16,19,1289,264,1553,921,596,4244,28,34,559,1598,45,1517,62
34003054600,0.9488163787587972,0.05118362124120281,1094,0,3097,257,822,"Census Tract 546, Bergen County, New Jersey",0,170,106,247,212,124,235,2036,930,2966,1105,1834,6377,80,78,2033,3126,160,2939,158
34003055100,0.9723606705935659,0.027639329406434075,474,0,1187,78,700,"Census Tract 551, Bergen County, New Jersey",0,45,99,76,16,71,167,1750,396,2146,757,419,5759,11,0,955,2207,61,1176,11
34003055200,0.952639751552795,0.04736024844720497,646,0.005822981366459627,1770,27,712,"Census Tract 552, Bergen County, New Jersey",15,128,22,98,151,52,195,1823,631,2454,1064,658,5737,26,22,2103,2576,122,1722,48
34003056100,0.9935972060535506,0.006402793946449359,69,0.004656577415599534,1938,17,117,"Census Tract 561, Bergen County, New Jersey",8,9,0,0,0,0,60,1599,108,1707,1161,731,4707,8,38,259,1718,11,1892,46
34003056200,0.9754440961337513,0.024555903866248695,314,0,2129,111,215,"Census Tract 562, Bergen County, New Jersey",0,26,18,9,44,83,134,1610,257,1867,1179,914,4556,27,9,426,1914,47,2093,36
34003057101,0.951048951048951,0.04895104895104895,1705,0.01098901098901099,1063,175,412,"Census Tract 571.01, Bergen County, New Jersey",22,453,49,486,215,120,382,468,1436,1904,316,477,1265,187,83,3193,2002,98,793,270
34003057102,0.8795686039544638,0.12043139604553625,798,0,1469,96,96,"Census Tract 571.02, Bergen County, New Jersey",0,0,0,0,0,118,680,1000,468,1468,333,1004,2582,121,11,1076,1669,201,1337,132
34003057200,0.9005524861878453,0.09944751381215469,1186,0,486,182,191,"Census Tract 572, Bergen County, New Jersey",0,35,38,0,33,279,801,466,838,1304,187,202,1346,97,0,2110,1448,144,389,97
34003058100,0.9428369795342273,0.05716302046577276,143,0,1604,33,147,"Census Tract 581, Bergen County, New Jersey",0,0,55,79,9,0,0,1243,93,1336,804,743,3516,0,57,290,1417,81,1547,57
34003058200,0.9715302491103203,0.028469750889679714,16,0,2454,77,333,"Census Tract 582, Bergen County, New Jersey",0,0,0,0,8,8,0,1820,91,1911,972,1452,5129,0,30,308,1967,56,2424,30
34003059100,0.9477712742008104,0.05222872579918955,1451,0,1376,169,273,"Census Tract 591, Bergen County, New Jersey",0,289,56,342,180,336,248,826,1279,2105,706,527,2534,130,13,2762,2221,116,1233,143
34003059200,0.9673590504451038,0.032640949554896145,634,0,2067,245,525,"Census Tract 592, Bergen County, New Jersey",0,114,0,284,0,30,206,1770,512,2282,1108,942,5041,0,17,738,2359,77,2050,17
34003060000,0.9829596412556054,0.017040358744394617,1294,0,3016,192,494,"Census Tract 600, Bergen County, New Jersey",0,98,104,279,159,290,364,2243,1045,3288,1209,1509,6498,114,184,2126,3345,57,2718,298
34003061100,0.9795795795795795,0.02042042042042042,59,0,1627,34,244,"Census Tract 611, Bergen County, New Jersey",0,0,17,0,7,14,21,1533,98,1631,909,718,4277,0,0,271,1665,34,1627,0
34003061200,0.9426494345718901,0.05735056542810985,119,0,1123,0,72,"Census Tract 612, Bergen County, New Jersey",0,0,0,0,7,39,73,1053,114,1167,625,498,3063,0,0,252,1238,71,1123,0
34003061300,0.9697465249386754,0.03025347506132461,164,0,1250,111,200,"Census Tract 613, Bergen County, New Jersey",0,0,44,76,10,0,34,1012,174,1186,573,609,3156,47,21,243,1223,37,1182,68
34003061400,0.9745906267645398,0.025409373235460192,4,0,2226,7,243,"Census Tract 614, Bergen County, New Jersey",0,0,0,0,0,0,4,1651,75,1726,1261,942,5022,23,0,239,1771,45,2203,23
34005700102,0.890497737556561,0.10950226244343891,131,0.008144796380090498,729,46,63,"Census Tract 7001.02, Burlington County, New Jersey",9,42,16,0,21,0,52,789,195,984,192,530,2081,7,0,525,1105,121,722,7
34005700103,0.8760053619302949,0.1239946380697051,295,0,842,6,21,"Census Tract 7001.03, Burlington County, New Jersey",0,109,48,40,69,0,29,914,393,1307,453,363,1919,26,0,889,1492,185,816,26
34005700104,0.8591916558018253,0.1408083441981747,246,0,526,92,89,"Census Tract 7001.04, Burlington County, New Jersey",0,0,0,0,71,57,118,365,294,659,246,266,1064,0,14,745,767,108,512,14
34005700200,0.9332706766917294,0.06672932330827068,251,0,956,31,89,"Census Tract 7002, Burlington County, New Jersey",0,30,0,0,69,56,96,774,219,993,532,419,2164,0,5,464,1064,71,951,5
34005700303,0.8695388349514563,0.1304611650485437,421,0,1007,40,171,"Census Tract 7003.03, Burlington County, New Jersey",0,71,197,7,95,21,30,1005,428,1433,375,590,2650,42,0,883,1648,215,965,42
34005700304,0.9791437980241493,0.020856201975850714,4,0,880,26,34,"Census Tract 7003.04, Burlington County, New Jersey",0,0,0,0,0,0,4,838,54,892,344,536,2442,0,0,132,911,19,880,0
34005700305,0.9377637130801688,0.06223628691983123,169,0,2407,66,65,"Census Tract 7003.05, Burlington County, New Jersey",0,49,0,0,102,18,0,1712,66,1778,1329,1078,4882,0,0,130,1896,118,2407,0
34005700306,0.9354120267260579,0.0645879732739421,15,0,986,12,52,"Census Tract 7003.06, Burlington County, New Jersey",0,15,0,0,0,0,0,783,57,840,515,471,2238,0,0,233,898,58,986,0
34005700307,0.9691991786447639,0.030800821355236138,0,0,906,0,118,"Census Tract 7003.07, Burlington County, New Jersey",0,0,0,0,0,0,0,892,52,944,493,413,2591,0,0,152,974,30,906,0
34005700401,0.9381188118811881,0.06188118811881188,119,0,898,10,23,"Census Tract 7004.01, Burlington County, New Jersey",0,37,0,8,30,13,31,615,143,758,443,429,1663,26,0,300,808,50,872,26
34005700402,0.9558263518659559,0.044173648134044174,78,0,1470,48,103,"Census Tract 7004.02, Burlington County, New Jersey",0,0,0,0,0,30,48,1163,92,1255,748,712,2994,0,10,172,1313,58,1460,10
34005700403,0.9892045454545455,0.010795454545454546,430,0.002840909090909091,1726,103,45,"Census Tract 7004.03, Burlington County, New Jersey",5,44,38,123,28,149,48,1228,513,1741,871,830,3370,25,0,965,1760,19,1701,25
34005700405,0.9529243937232525,0.047075606276747506,82,0,726,19,22,"Census Tract 7004.05, Burlington County, New Jersey",0,15,31,5,0,6,25,528,140,668,278,431,1491,17,0,375,701,33,709,17
34005700407,0.9115272844688408,0.08847271553115918,2921,0,397,317,151,"Census Tract 7004.07, Burlington County, New Jersey",0,476,801,753,189,538,164,313,2510,2823,51,61,463,233,52,4566,3097,274,112,285
34005700408,0.8662464985994398,0.13375350140056022,1332,0,122,113,58,"Census Tract 7004.08, Burlington County, New Jersey",0,424,160,136,397,195,20,130,1107,1237,29,53,247,24,16,1829,1428,191,82,40
34005700501,0.9555860805860806,0.044413919413919416,575,0,2000,131,214,"Census Tract 7005.01, Burlington County, New Jersey",0,137,143,32,164,76,23,1503,584,2087,1179,742,4195,79,0,1205,2184,97,1921,79
34005700502,0.9073359073359073,0.09266409266409266,74,0,906,50,25,"Census Tract 7005.02, Burlington County, New Jersey",0,12,4,33,0,10,15,624,81,705,419,442,1860,12,33,149,777,72,861,45
34005700503,0.9364620938628159,0.06353790613718412,140,0,1195,94,49,"Census Tract 7005.03, Burlington County, New Jersey",0,25,51,0,11,28,25,1145,152,1297,735,428,3257,13,19,302,1385,88,1163,32
34005700504,0.8867120954003407,0.11328790459965929,191,0,950,26,18,"Census Tract 7005.04, Burlington County, New Jersey",0,10,15,33,18,23,92,784,257,1041,562,388,2206,0,0,688,1174,133,950,0
34005700505,0.9451131439576312,0.0548868560423688,246,0,2035,74,86,"Census Tract 7005.05, Burlington County, New Jersey",0,0,30,204,0,12,0,1794,169,1963,1636,340,5747,59,0,472,2077,114,1976,59
34005700602,0.8950252951096122,0.10497470489038786,357,0,1330,55,129,"Census Tract 7006.02, Burlington County, New Jersey",0,107,70,0,112,19,49,1964,159,2123,816,468,5292,46,0,485,2372,249,1284,46
34005700603,0.953719723183391,0.046280276816609,934,0,1579,114,56,"Census Tract 7006.03, Burlington County, New Jersey",0,468,43,71,28,144,180,1294,911,2205,705,778,4102,96,0,1875,2312,107,1483,96
34005700605,0.9300578034682081,0.06994219653179191,254,0,1933,67,100,"Census Tract 7006.05, Burlington County, New Jersey",0,95,73,39,27,20,0,1276,333,1609,774,992,3945,131,36,897,1730,121,1766,167
34005700701,0.9479768786127167,0.05202312138728324,293,0,1037,84,8,"Census Tract 7007.01, Burlington County, New Jersey",0,46,8,0,33,102,104,868,444,1312,284,597,2007,156,0,1237,1384,72,881,156
34005700702,0.8645224171539961,0.1354775828460039,218,0,838,142,35,"Census Tract 7007.02, Burlington County, New Jersey",0,0,6,7,56,54,95,551,336,887,322,408,1569,108,0,913,1026,139,730,108
34005700703,0.8189054726368159,0.18109452736318407,288,0,809,74,61,"Census Tract 7007.03, Burlington County, New Jersey",0,0,0,0,37,102,149,497,326,823,293,476,1291,7,33,858,1005,182,769,40
34005700800,0.9487541137752703,0.05124588622472966,350,0.005641748942172073,1352,85,187,"Census Tract 7008, Burlington County, New Jersey",12,21,0,138,21,53,117,1523,495,2018,534,779,3592,6,33,893,2127,109,1313,39
34005700900,0.810251798561151,0.18974820143884893,311,0,928,109,38,"Census Tract 7009, Burlington County, New Jersey",0,11,23,0,5,149,123,645,256,901,370,547,1754,11,0,594,1112,211,917,11
34005701001,0.9504862953138815,0.04951370468611848,1724,0,1098,215,112,"Census Tract 7010.01, Burlington County, New Jersey",0,325,41,118,803,289,148,942,1208,2150,523,440,2066,114,21,3115,2262,112,963,135
34005701002,0.9045553145336226,0.09544468546637744,265,0,1213,44,7,"Census Tract 7010.02, Burlington County, New Jersey",0,62,74,17,19,63,30,985,266,1251,399,814,2872,0,0,671,1383,132,1213,0
34005701102,0.9831288343558282,0.01687116564417178,329,0,1224,92,124,"Census Tract 7011.02, Burlington County, New Jersey",0,69,11,38,110,92,9,1604,319,1923,1058,92,4906,63,11,436,1956,33,1150,74
34005701103,0.9565018315018315,0.043498168498168496,115,0,2041,60,243,"Census Tract 7011.03, Burlington County, New Jersey",0,64,19,0,20,0,12,1892,197,2089,1318,723,5878,0,0,383,2184,95,2041,0
34005701104,0.8818458417849898,0.11815415821501014,663,0,1317,116,56,"Census Tract 7011.04, Burlington County, New Jersey",0,499,53,28,19,34,30,1117,622,1739,640,506,3124,139,32,1466,1972,233,1146,171
34005701105,0.9928251121076234,0.007174887892376682,448,0,1435,144,59,"Census Tract 7011.05, Burlington County, New Jersey",0,67,86,55,121,89,30,1671,543,2214,966,469,4504,0,0,1267,2230,16,1435,0
34005701201,0.9459665144596652,0.05403348554033485,111,0.0045662100456621,936,64,33,"Census Tract 7012.01, Burlington County, New Jersey",6,0,0,0,24,0,87,1065,178,1243,321,546,2718,0,69,353,1314,71,867,69
34005701203,0.869615832363213,0.13038416763678695,212,0,662,60,10,"Census Tract 7012.03, Burlington County, New Jersey",0,101,13,20,35,18,25,478,269,747,280,348,1374,22,12,713,859,112,628,34
34005701204,0.759789156626506,0.24021084337349397,589,0,386,285,51,"Census Tract 7012.04, Burlington County, New Jersey",0,12,78,157,88,108,146,326,683,1009,0,324,881,40,22,1589,1328,319,324,62
34005701205,0.8275862068965517,0.1724137931034483,243,0,857,63,41,"Census Tract 7012.05, Burlington County, New Jersey",0,32,47,5,58,25,76,562,350,912,490,232,1310,135,0,843,1102,190,722,135
34005701301,0.8942937324602432,0.10570626753975679,677,0.023854069223573433,1195,191,120,"Census Tract 7013.01, Burlington County, New Jersey",51,29,124,61,231,120,112,1239,673,1912,472,629,2902,59,35,1521,2138,226,1101,94
34005701302,0.960801393728223,0.039198606271777,37,0,766,26,53,"Census Tract 7013.02, Burlington County, New Jersey",0,0,10,0,20,0,7,902,201,1103,380,386,2215,0,0,597,1148,45,766,0
34005701303,0.9182156133828996,0.08178438661710037,28,0,1069,61,135,"Census Tract 7013.03, Burlington County, New Jersey",0,0,0,0,0,19,9,1879,97,1976,391,657,5026,21,0,328,2152,176,1048,21
34005701401,0.9784668389319552,0.02153316106804479,0,0,1420,17,168,"Census Tract 7014.01, Burlington County, New Jersey",0,0,0,0,0,0,0,2146,126,2272,721,566,6070,100,33,323,2322,50,1287,133
34005701402,0.9919614147909968,0.008038585209003215,0,0.006430868167202572,597,153,12,"Census Tract 7014.02, Burlington County, New Jersey",8,0,0,0,0,0,0,1206,28,1234,320,261,2092,0,16,53,1244,10,581,16
34005701502,0.9052083333333333,0.09479166666666666,514,0,1058,75,43,"Census Tract 7015.02, Burlington County, New Jersey",0,168,0,57,188,79,22,1174,564,1738,377,651,3002,21,9,1053,1920,182,1028,30
34005701700,0.8477937530986613,0.15220624690133863,788,0,969,125,43,"Census Tract 7017, Burlington County, New Jersey",0,133,82,66,96,250,161,880,830,1710,398,446,2253,93,32,1494,2017,307,844,125
34005702101,0.9311594202898551,0.06884057971014493,110,0,0,10,25,"Census Tract 7021.01, Burlington County, New Jersey",0,3,0,3,33,51,20,0,1285,1285,0,0,0,0,0,4366,1380,95,0,0
34005702203,0.9671268902038133,0.03287310979618672,533,0,1358,27,86,"Census Tract 7022.03, Burlington County, New Jersey",0,212,77,74,65,92,13,848,623,1471,351,972,2384,15,20,1196,1521,50,1323,35
34005702204,0.9298701298701298,0.07012987012987013,59,0,618,45,0,"Census Tract 7022.04, Burlington County, New Jersey",0,0,6,0,0,19,34,468,248,716,338,280,1355,0,0,663,770,54,618,0
34005702206,0.9124839124839125,0.08751608751608751,87,0,827,37,8,"Census Tract 7022.06, Burlington County, New Jersey",0,16,26,0,17,18,10,510,199,709,307,436,1492,47,37,563,777,68,743,84
34005702207,0.8543492919757248,0.14565070802427513,185,0.3209710047201618,897,70,0,"Census Tract 7022.07, Burlington County, New Jersey",476,37,4,10,22,68,44,973,294,1267,476,253,2241,146,22,855,1483,216,729,168
34005702208,0.8507692307692307,0.14923076923076922,10,0,2414,85,19,"Census Tract 7022.08, Burlington County, New Jersey",0,10,0,0,0,0,0,1912,300,2212,1099,1311,5557,0,4,1051,2600,388,2410,4
34005702209,0.946218487394958,0.05378151260504202,8,0.007563025210084034,938,50,0,"Census Tract 7022.09, Burlington County, New Jersey",9,0,0,0,0,8,0,871,255,1126,348,565,2388,16,9,765,1190,64,913,25
34005702210,0.8668122270742358,0.1331877729257642,223,0.07751091703056769,1159,125,2,"Census Tract 7022.10, Burlington County, New Jersey",142,40,16,17,60,59,31,1154,434,1588,452,649,3391,52,6,1071,1832,244,1101,58
34005702300,0.8846153846153846,0.11538461538461539,176,0,244,44,25,"Census Tract 7023, Burlington County, New Jersey",0,48,3,10,16,73,26,378,197,575,126,89,930,8,21,481,650,75,215,29
34005702400,0.909245122985581,0.090754877014419,22,0,1294,16,33,"Census Tract 7024, Burlington County, New Jersey",0,0,0,0,7,5,10,962,110,1072,544,648,2911,0,102,379,1179,107,1192,102
34005702500,0.9763369616658779,0.023663038334122102,470,0.03076194983435873,1962,50,5,"Census Tract 7025, Burlington County, New Jersey",65,195,44,18,35,158,20,1393,670,2063,991,971,4400,0,0,1552,2113,50,1962,0
34005702601,0.9348837209302325,0.06511627906976744,408,0,1637,63,41,"Census Tract 7026.01, Burlington County, New Jersey",0,169,0,0,22,183,34,1365,444,1809,678,948,3711,0,11,865,1935,126,1626,11
34005702603,0.8377581120943953,0.16224188790560473,363,0,459,99,24,"Census Tract 7026.03, Burlington County, New Jersey",0,0,0,0,101,164,98,358,494,852,107,247,894,44,61,1198,1017,165,354,105
34005702700,0.9276932084309133,0.07230679156908665,68,0,2962,97,163,"Census Tract 7027, Burlington County, New Jersey",0,36,19,0,13,0,0,2933,236,3169,2097,792,8162,0,73,534,3416,247,2889,73
34005702801,0.9203778677462888,0.0796221322537112,0,0,815,7,56,"Census Tract 7028.01, Burlington County, New Jersey",0,0,0,0,0,0,0,587,95,682,133,656,1746,6,20,336,741,59,789,26
34005702802,0.8985382631126397,0.10146173688736028,11,0.021496130696474634,1309,46,85,"Census Tract 7028.02, Burlington County, New Jersey",25,0,0,0,0,11,0,1000,45,1045,330,979,3233,0,0,119,1163,118,1309,0
34005702803,0.92790863668808,0.07209136331192005,15,0,1476,72,139,"Census Tract 7028.03, Burlington County, New Jersey",0,9,0,0,0,6,0,1135,165,1300,549,847,3183,0,80,535,1401,101,1396,80
34005702804,0.9384920634920635,0.061507936507936505,0,0.01488095238095238,878,41,111,"Census Tract 7028.04, Burlington County, New Jersey",15,0,0,0,0,0,0,827,119,946,325,537,2130,16,0,386,1008,62,862,16
34005702805,0.8964451313755796,0.1035548686244204,0,0.02241112828438949,1655,26,73,"Census Tract 7028.05, Burlington County, New Jersey",29,0,0,0,0,0,0,901,259,1160,830,773,2581,52,0,1386,1294,134,1603,52
34005702806,0.8380503144654088,0.1619496855345912,0,0.02830188679245283,1181,75,77,"Census Tract 7028.06, Burlington County, New Jersey",36,0,0,0,0,0,0,842,224,1066,486,653,2450,32,10,806,1272,206,1139,42
34005702807,0.8503453568687643,0.1496546431312356,308,0,789,182,93,"Census Tract 7028.07, Burlington County, New Jersey",0,117,109,82,0,0,0,584,524,1108,211,578,1847,0,0,1549,1303,195,789,0
34005702808,0.9313380281690141,0.06866197183098592,0,0,1505,30,210,"Census Tract 7028.08, Burlington County, New Jersey",0,0,0,0,0,0,0,844,214,1058,318,1171,2558,0,16,825,1136,78,1489,16
34005702809,0.8247950819672131,0.17520491803278687,189,0,281,49,41,"Census Tract 7028.09, Burlington County, New Jersey",0,67,77,0,45,0,0,375,430,805,198,83,856,0,0,1277,976,171,281,0
34005702810,0.8817204301075269,0.11827956989247312,10,0,426,11,17,"Census Tract 7028.10, Burlington County, New Jersey",0,0,0,0,0,10,0,393,17,410,239,187,1229,0,0,57,465,55,426,0
34005702811,0.868763557483731,0.13123644251626898,0,0,1280,14,124,"Census Tract 7028.11, Burlington County, New Jersey",0,0,0,0,0,0,0,782,19,801,318,852,2296,0,110,110,922,121,1170,110
34005702905,0.9397260273972603,0.06027397260273973,722,0,1237,0,98,"Census Tract 7029.05, Burlington County, New Jersey",0,187,96,97,215,90,37,1066,649,1715,627,561,2863,49,0,1262,1825,110,1188,49
34005702906,0.9131782945736434,0.08682170542635659,8,0,828,10,23,"Census Tract 7029.06, Burlington County, New Jersey",0,0,0,0,0,0,8,534,55,589,492,328,1748,0,8,148,645,56,820,8
34005702907,0.9125200642054575,0.08747993579454254,9,0,1007,35,48,"Census Tract 7029.07, Burlington County, New Jersey",0,0,0,0,0,9,0,1110,27,1137,560,447,2551,0,0,78,1246,109,1007,0
34005702908,0.9673330082886397,0.03266699171136031,134,0,1445,70,40,"Census Tract 7029.08, Burlington County, New Jersey",0,0,0,0,61,73,0,1881,103,1984,1021,424,4008,0,0,132,2051,67,1445,0
34005702909,0.9691044192412984,0.030895580758701604,573,0,1704,32,49,"Census Tract 7029.09, Burlington County, New Jersey",0,55,0,40,342,119,17,2018,460,2478,1028,629,4919,47,0,1494,2557,79,1657,47
34005702910,0.95088868101029,0.04911131898971001,341,0.0940130963517306,1399,62,179,"Census Tract 7029.10, Burlington County, New Jersey",201,0,19,36,204,20,62,1757,276,2033,1229,170,4619,0,0,472,2138,105,1399,0
34005702913,0.9393825301204819,0.06061746987951807,1685,0,504,108,0,"Census Tract 7029.13, Burlington County, New Jersey",0,489,287,83,603,191,32,1342,1153,2495,270,163,2418,71,0,2551,2656,161,433,71
34005702914,0.9421747328724073,0.05782526712759271,0,0,1591,14,102,"Census Tract 7029.14, Burlington County, New Jersey",0,0,0,0,0,0,0,1294,205,1499,642,838,3580,104,7,656,1591,92,1480,111
34005702915,0.9563557010365521,0.0436442989634479,637,0,966,48,100,"Census Tract 7029.15, Burlington County, New Jersey",0,69,27,16,246,153,126,1141,612,1753,463,419,2686,59,25,1571,1833,80,882,84
34005702917,0.918562874251497,0.081437125748503,191,0,547,14,39,"Census Tract 7029.17, Burlington County, New Jersey",0,0,0,5,167,5,14,648,119,767,366,181,1630,0,0,200,835,68,547,0
34005702918,0.918232044198895,0.08176795580110498,220,0.0066298342541436465,316,16,25,"Census Tract 7029.18, Burlington County, New Jersey",6,8,0,0,168,44,0,685,146,831,206,98,1442,12,0,288,905,74,304,12
34005703000,0.9729497638471447,0.027050236152855303,110,0.025332760841562902,2351,39,147,"Census Tract 7030, Burlington County, New Jersey",59,0,0,25,40,29,16,2053,213,2266,1430,835,5612,61,25,412,2329,63,2265,86
34005703102,0.9557613168724279,0.044238683127572016,23,0,604,10,67,"Census Tract 7031.02, Burlington County, New Jersey",0,0,0,0,12,5,6,794,135,929,278,306,2444,15,5,217,972,43,584,20
34005703103,0.8800936768149883,0.11990632318501171,817,0,776,109,68,"Census Tract 7031.03, Burlington County, New Jersey",0,434,106,66,97,55,59,942,937,1879,555,114,2564,46,61,2098,2135,256,669,107
34005703104,0.9819967266775778,0.01800327332242226,121,0.016366612111292964,1882,70,140,"Census Tract 7031.04, Burlington County, New Jersey",30,37,73,11,0,0,0,1543,257,1800,1304,553,4279,25,0,498,1833,33,1857,25
34005703201,0.9534726904922455,0.04652730950775455,6,0.20768712070128117,1715,50,17,"Census Tract 7032.01, Burlington County, New Jersey",308,0,0,0,0,0,6,1340,74,1414,658,1037,3581,20,0,144,1483,69,1695,20
34005703202,0.9007021063189569,0.09929789368104312,4,0,1292,19,0,"Census Tract 7032.02, Burlington County, New Jersey",0,0,0,0,0,0,4,773,125,898,579,683,2238,12,18,387,997,99,1262,30
34005703203,0.9214060031595577,0.07859399684044234,0,0,933,226,17,"Census Tract 7032.03, Burlington County, New Jersey",0,0,0,0,0,0,0,2171,162,2333,377,486,3492,70,0,352,2532,199,863,70
34005703600,0.978017420157611,0.02198257984238905,0,0.019493985897967647,2815,23,28,"Census Tract 7036, Burlington County, New Jersey",47,0,0,0,0,0,0,2196,162,2358,865,1888,6402,33,29,458,2411,53,2753,62
34005703700,0.9847259658580413,0.015274034141958671,0,0.13432165318957773,2382,76,77,"Census Tract 7037, Burlington County, New Jersey",299,0,0,0,0,0,0,2071,121,2192,1122,1216,6113,44,0,269,2226,34,2338,44
34005703801,0.9582225598176984,0.041777440182301555,426,0,2660,217,128,"Census Tract 7038.01, Burlington County, New Jersey",0,16,37,57,316,0,0,2104,419,2523,1846,814,5995,0,0,782,2633,110,2660,0
34005703802,0.94180407371484,0.058195926285160036,531,0,983,66,45,"Census Tract 7038.02, Burlington County, New Jersey",0,220,48,57,105,72,29,1287,655,1942,618,313,3172,43,9,1312,2062,120,931,52
34005703803,0.9741282339707537,0.025871766029246346,20,0,1777,10,103,"Census Tract 7038.03, Burlington County, New Jersey",0,0,0,11,0,0,9,1599,133,1732,1011,766,4401,0,0,403,1778,46,1777,0
34005703804,0.9433729995896594,0.056627000410340585,17,0,2659,12,166,"Census Tract 7038.04, Burlington County, New Jersey",0,0,0,0,0,0,17,2246,53,2299,1590,1069,6847,0,0,148,2437,138,2659,0
34005703900,0.9812834224598931,0.01871657754010695,0,0,1624,0,59,"Census Tract 7039, Burlington County, New Jersey",0,0,0,0,0,0,0,1388,80,1468,759,865,3825,0,0,206,1496,28,1624,0
34005704004,0.9044975013881177,0.09550249861188229,877,0,1038,36,84,"Census Tract 7040.04, Burlington County, New Jersey",0,273,256,108,114,100,26,869,760,1629,559,389,2328,58,32,1350,1801,172,948,90
34005704005,0.9517857142857142,0.048214285714285716,685,0,1326,172,76,"Census Tract 7040.05, Burlington County, New Jersey",0,130,27,195,238,60,35,1057,542,1599,690,613,2975,23,0,967,1680,81,1303,23
34005704006,0.9043112513144059,0.09568874868559411,224,0,887,12,25,"Census Tract 7040.06, Burlington County, New Jersey",0,85,23,17,43,35,21,715,145,860,446,421,1791,3,17,267,951,91,867,20
34005704007,0.9497021839841164,0.05029781601588352,341,0,1557,192,104,"Census Tract 7040.07, Burlington County, New Jersey",0,0,32,206,37,49,17,989,446,1435,693,808,2725,56,0,659,1511,76,1501,56
34005704008,0.9488692232055064,0.051130776794493606,440,0,2602,48,147,"Census Tract 7040.08, Burlington County, New Jersey",0,79,0,61,111,109,80,1453,477,1930,1803,710,4160,34,55,898,2034,104,2513,89
34005704009,0.8753768844221106,0.12462311557788945,952,0,1315,94,62,"Census Tract 7040.09, Burlington County, New Jersey",0,81,150,61,398,174,88,1000,742,1742,1033,234,3015,48,0,1483,1990,248,1267,48
34005704011,0.9587443946188341,0.04125560538116592,0,0,1121,17,33,"Census Tract 7040.11, Burlington County, New Jersey",0,0,0,0,0,0,0,1038,31,1069,752,369,3026,0,0,87,1115,46,1121,0
34005704012,0.8821292775665399,0.11787072243346007,553,0,1766,32,116,"Census Tract 7040.12, Burlington County, New Jersey",0,228,10,11,163,131,10,1962,358,2320,1134,632,4765,0,0,911,2630,310,1766,0
34005704013,0.9675433687744823,0.032456631225517625,36,0,2086,12,88,"Census Tract 7040.13, Burlington County, New Jersey",0,0,0,0,0,0,36,1689,40,1729,1350,736,4971,0,0,105,1787,58,2086,0
34005704014,1,0,320,0,1598,211,151,"Census Tract 7040.14, Burlington County, New Jersey",0,68,0,165,87,0,0,2539,604,3143,1115,462,6934,0,21,1372,3143,0,1577,21
34005704200,0.9287888009738283,0.07121119902617164,414,0.005173463177115033,2787,33,106,"Census Tract 7042, Burlington County, New Jersey",17,106,171,60,29,24,24,2457,595,3052,1544,1075,7181,126,42,1268,3286,234,2619,168
34005704302,0.9561883899233297,0.04381161007667032,27,0,1414,27,222,"Census Tract 7043.02, Burlington County, New Jersey",0,11,0,0,0,9,7,1619,127,1746,824,500,5312,90,0,381,1826,80,1324,90
34005704500,0.8930390492359932,0.10696095076400679,363,0.22750424448217318,1317,70,15,"Census Tract 7045, Burlington County, New Jersey",402,26,35,0,216,66,20,1100,478,1578,770,482,2697,38,27,1102,1767,189,1252,65
34005704600,0.7961246840775064,0.2038753159224937,391,0,715,93,9,"Census Tract 7046, Burlington County, New Jersey",0,0,10,109,0,87,185,532,413,945,321,255,1429,132,7,753,1187,242,576,139
34005704700,0.9258474576271186,0.07415254237288135,13,0.04519774011299435,1453,36,5,"Census Tract 7047, Burlington County, New Jersey",64,0,0,0,0,4,9,1096,215,1311,697,710,2914,0,46,546,1416,105,1407,46
34005704801,0.9334637964774951,0.06653620352250489,61,0,414,9,0,"Census Tract 7048.01, Burlington County, New Jersey",0,0,0,0,9,5,47,260,694,954,176,238,721,0,0,2096,1022,68,414,0
34005704802,0.7720588235294118,0.22794117647058823,102,0,6,5,0,"Census Tract 7048.02, Burlington County, New Jersey",0,21,18,52,0,11,0,5,205,210,0,0,5,6,0,657,272,62,0,6
34005981802,0.5714285714285714,0.42857142857142855,0,0,20,0,0,"Census Tract 9818.02, Burlington County, New Jersey",0,0,0,0,0,0,0,12,0,12,0,20,40,0,0,0,21,9,20,0
34005982111,0.944,0.056,6,0,0,0,0,"Census Tract 9821.11, Burlington County, New Jersey",0,3,0,0,0,3,0,0,118,118,0,0,0,0,0,410,125,7,0,0
34007600200,0.7350054525627044,0.2649945474372955,188,0.017448200654307525,589,264,148,"Census Tract 6002, Camden County, New Jersey",16,16,0,0,0,22,150,359,315,674,259,300,993,30,0,940,917,243,559,30
34007600400,0.7449062754686226,0.25509372453137735,157,0.019559902200488997,726,365,152,"Census Tract 6004, Camden County, New Jersey",24,0,0,83,0,0,74,351,563,914,60,539,790,80,47,2023,1227,313,599,127
34007600700,0.7557755775577558,0.24422442244224424,181,0,379,137,114,"Census Tract 6007, Camden County, New Jersey",0,30,0,0,6,55,90,133,325,458,141,78,411,102,58,1053,606,148,219,160
34007600800,0.837573385518591,0.162426614481409,932,0,1551,1028,256,"Census Tract 6008, Camden County, New Jersey",0,99,145,581,0,65,42,311,1401,1712,334,597,1164,504,116,3843,2044,332,931,620
34007600900,0.9057406094968108,0.09425939050318922,489,0,841,449,151,"Census Tract 6009, Camden County, New Jersey",0,121,42,45,79,24,178,331,947,1278,200,209,985,261,171,3062,1411,133,409,432
34007601000,0.8922693266832917,0.10773067331670823,372,0.012967581047381545,1822,380,287,"Census Tract 6010, Camden County, New Jersey",26,125,0,0,83,93,71,1006,783,1789,1144,400,3715,278,0,2779,2005,216,1544,278
34007601101,0.8199608610567515,0.18003913894324852,276,0.019569471624266144,665,182,63,"Census Tract 6011.01, Camden County, New Jersey",20,78,0,0,33,101,64,329,509,838,155,412,1473,71,27,1810,1022,184,567,98
34007601102,0.9060899260102447,0.09391007398975526,474,0,1971,483,112,"Census Tract 6011.02, Camden County, New Jersey",0,31,67,128,10,30,208,768,824,1592,1063,509,3021,204,195,2686,1757,165,1572,399
34007601200,0.8877272727272727,0.11227272727272727,519,0,2286,428,392,"Census Tract 6012, Camden County, New Jersey",0,84,65,0,12,212,146,1232,721,1953,1405,753,3885,44,84,2406,2200,247,2158,128
34007601300,0.7610837438423645,0.23891625615763548,623,0,617,713,388,"Census Tract 6013, Camden County, New Jersey",0,0,112,162,12,53,284,549,996,1545,37,420,1315,103,57,2990,2030,485,457,160
34007601400,0.8375,0.1625,472,0,1505,484,249,"Census Tract 6014, Camden County, New Jersey",0,40,0,52,18,92,270,786,822,1608,375,853,1944,41,236,2655,1920,312,1228,277
34007601500,0.7436166491780343,0.2563833508219657,1013,0,1360,611,134,"Census Tract 6015, Camden County, New Jersey",0,97,262,146,284,168,56,715,1411,2126,441,646,1932,175,98,2914,2859,733,1087,273
34007601600,0.9180171591992373,0.08198284080076262,213,0,427,394,77,"Census Tract 6016, Camden County, New Jersey",0,43,9,10,77,14,60,291,672,963,67,161,618,103,96,2005,1049,86,228,199
34007601700,0.8837837837837837,0.11621621621621622,729,0.037162162162162164,275,766,112,"Census Tract 6017, Camden County, New Jersey",55,204,115,229,51,68,62,106,1202,1308,49,43,239,50,133,2907,1480,172,92,183
34007601800,0.7343234323432343,0.26567656765676567,133,0.013201320132013201,231,154,128,"Census Tract 6018, Camden County, New Jersey",8,0,0,0,9,0,124,272,173,445,28,172,756,31,0,445,606,161,200,31
34007601900,0.8223787167449139,0.17762128325508608,446,0,671,264,120,"Census Tract 6019, Camden County, New Jersey",0,74,66,36,33,169,68,395,656,1051,144,304,942,172,51,1785,1278,227,448,223
34007602000,0.7962052002810963,0.2037947997189037,649,0.03619114546732256,648,743,544,"Census Tract 6020, Camden County, New Jersey",103,86,144,22,255,57,85,989,1277,2266,366,282,2377,0,0,4096,2846,580,648,0
34007602503,0.8468368479467259,0.15316315205327413,43,0,1047,48,96,"Census Tract 6025.03, Camden County, New Jersey",0,19,0,7,0,0,17,638,125,763,441,601,1867,0,5,550,901,138,1042,5
34007602601,0.8976377952755905,0.10236220472440945,10,0,1239,51,48,"Census Tract 6026.01, Camden County, New Jersey",0,0,0,0,0,0,10,804,108,912,852,387,2340,0,0,324,1016,104,1239,0
34007602602,0.9721189591078067,0.027881040892193308,227,0,749,227,105,"Census Tract 6026.02, Camden County, New Jersey",0,32,0,71,0,111,13,702,344,1046,188,509,2007,0,52,940,1076,30,697,52
34007602901,0.9246987951807228,0.07530120481927711,352,0,1910,117,130,"Census Tract 6029.01, Camden County, New Jersey",0,20,72,106,50,12,92,1547,295,1842,693,1139,3832,48,30,574,1992,150,1832,78
34007602902,0.9256068911511355,0.07439310884886452,430,0,762,248,62,"Census Tract 6029.02, Camden County, New Jersey",0,22,72,0,44,244,48,823,359,1182,336,364,2726,35,27,578,1277,95,700,62
34007603001,0.9793447293447294,0.020655270655270654,120,0,1710,45,140,"Census Tract 6030.01, Camden County, New Jersey",0,10,0,0,5,30,75,1129,246,1375,542,895,3099,158,115,802,1404,29,1437,273
34007603002,0.8904443091905052,0.10955569080949483,259,0,1446,85,145,"Census Tract 6030.02, Camden County, New Jersey",0,55,0,0,0,133,71,1169,294,1463,720,666,3448,0,60,1062,1643,180,1386,60
34007603100,0.905140758873929,0.094859241126071,674,0,588,174,201,"Census Tract 6031, Camden County, New Jersey",0,93,59,85,83,118,236,851,628,1479,219,339,2452,30,0,1248,1634,155,558,30
34007603200,0.8470627954085078,0.15293720459149224,899,0.049966239027684,2416,275,187,"Census Tract 6032, Camden County, New Jersey",148,212,246,305,91,30,15,1651,858,2509,1119,1281,4865,16,0,1686,2962,453,2400,16
34007603301,0.9261261261261261,0.07387387387387387,940,0,1564,113,165,"Census Tract 6033.01, Camden County, New Jersey",0,45,129,707,21,0,38,1310,746,2056,680,840,3814,0,44,1623,2220,164,1520,44
34007603302,0.9381573411863694,0.06184265881363063,300,0,2680,82,126,"Census Tract 6033.02, Camden County, New Jersey",0,0,18,250,15,17,0,1830,400,2230,1632,980,5152,34,34,1189,2377,147,2612,68
34007603303,0.9251940719830628,0.0748059280169372,897,0,844,262,74,"Census Tract 6033.03, Camden County, New Jersey",0,13,30,844,0,0,10,561,750,1311,504,218,1395,112,10,1295,1417,106,722,122
34007603400,0.9646291208791209,0.03537087912087912,1089,0,3064,82,271,"Census Tract 6034, Camden County, New Jersey",0,0,55,950,16,23,45,2020,789,2809,1609,1348,5654,17,90,1564,2912,103,2957,107
34007603501,0.926161175069472,0.07383882493052799,543,0,2328,168,239,"Census Tract 6035.01, Camden County, New Jersey",0,188,147,39,135,34,0,1676,657,2333,1393,886,4781,49,0,1432,2519,186,2279,49
34007603503,0.9907464528069093,0.009253547193090685,7,0,1800,33,181,"Census Tract 6035.03, Camden County, New Jersey",0,7,0,0,0,0,0,1581,25,1606,652,1143,4462,0,5,96,1621,15,1795,5
34007603504,0.9444444444444444,0.05555555555555555,52,0,1265,17,130,"Census Tract 6035.04, Camden County, New Jersey",0,0,0,18,22,6,6,872,46,918,568,697,2485,0,0,148,972,54,1265,0
34007603505,0.9472817133443163,0.05271828665568369,14,0,1660,19,166,"Census Tract 6035.05, Camden County, New Jersey",0,0,0,0,14,0,0,1097,53,1150,1074,586,3306,0,0,171,1214,64,1660,0
34007603506,0.9758924432081595,0.02410755679184052,59,0,2626,51,184,"Census Tract 6035.06, Camden County, New Jersey",0,0,0,59,0,0,0,2038,67,2105,1633,977,6012,0,16,91,2157,52,2610,16
34007603507,0.9448542325254654,0.0551457674745346,572,0,2404,213,208,"Census Tract 6035.07, Camden County, New Jersey",0,46,52,245,219,10,0,2168,522,2690,1538,840,5682,26,0,789,2847,157,2378,26
34007603601,0.9460552933243426,0.05394470667565745,346,0,1256,8,201,"Census Tract 6036.01, Camden County, New Jersey",0,88,0,63,80,95,20,1275,128,1403,558,617,3056,72,9,281,1483,80,1175,81
34007603602,0.9240924092409241,0.07590759075907591,14,0,1063,21,106,"Census Tract 6036.02, Camden County, New Jersey",0,0,0,0,0,0,14,804,36,840,407,634,2432,0,22,125,909,69,1041,22
34007603603,0.9479166666666666,0.052083333333333336,0,0,909,7,91,"Census Tract 6036.03, Camden County, New Jersey",0,0,0,0,0,0,0,785,34,819,412,497,2248,0,0,92,864,45,909,0
34007603700,0.9888816219751472,0.011118378024852845,534,0,974,62,140,"Census Tract 6037, Camden County, New Jersey",0,12,0,60,101,361,0,959,553,1512,477,476,2446,0,21,1435,1529,17,953,21
34007603800,0.9104552276138069,0.0895447723861931,270,0.00400200100050025,2159,104,309,"Census Tract 6038, Camden County, New Jersey",8,12,9,47,0,88,114,1541,279,1820,1127,947,4495,64,21,632,1999,179,2074,85
34007603901,0.9817351598173516,0.0182648401826484,630,0,1994,130,341,"Census Tract 6039.01, Camden County, New Jersey",0,53,0,214,103,193,67,1465,685,2150,861,1099,3907,19,15,1239,2190,40,1960,34
34007603902,0.887140902872777,0.11285909712722299,799,0,819,164,207,"Census Tract 6039.02, Camden County, New Jersey",0,22,51,605,30,4,87,645,652,1297,423,253,1731,114,29,1048,1462,165,676,143
34007604100,0.876803551609323,0.12319644839067703,137,0,587,130,151,"Census Tract 6041, Camden County, New Jersey",0,0,0,0,8,10,119,437,353,790,298,266,1517,23,0,1398,901,111,564,23
34007604200,0.8482142857142857,0.15178571428571427,624,0,781,198,210,"Census Tract 6042, Camden County, New Jersey",0,43,61,84,29,199,208,641,689,1330,359,391,1660,31,0,1481,1568,238,750,31
34007604300,0.8817494600431965,0.11825053995680346,691,0,1057,93,258,"Census Tract 6043, Camden County, New Jersey",0,61,94,174,10,101,251,1098,535,1633,375,621,2966,38,23,855,1852,219,996,61
34007604400,0.9544787077826725,0.04552129221732746,291,0,1256,68,263,"Census Tract 6044, Camden County, New Jersey",0,36,58,28,0,78,91,955,345,1300,515,708,2698,17,16,683,1362,62,1223,33
34007604600,0.90234375,0.09765625,437,0,511,101,74,"Census Tract 6046, Camden County, New Jersey",0,80,113,13,58,41,132,485,439,924,312,199,1200,0,0,813,1024,100,511,0
34007604700,0.9394703656998739,0.0605296343001261,57,0.029003783102143757,1035,7,20,"Census Tract 6047, Camden County, New Jersey",23,13,0,0,21,6,17,668,77,745,481,547,1813,7,0,128,793,48,1028,7
34007605100,0.8891235480464625,0.11087645195353749,62,0.03907074973600845,1031,47,20,"Census Tract 6051, Camden County, New Jersey",37,0,0,0,7,13,42,675,167,842,435,596,1716,0,0,399,947,105,1031,0
34007605200,0.9173708920187793,0.08262910798122065,140,0.15211267605633802,1052,92,96,"Census Tract 6052, Camden County, New Jersey",162,110,0,6,24,0,0,768,209,977,313,706,2174,33,0,683,1065,88,1019,33
34007605300,0.8617283950617284,0.1382716049382716,98,0,626,87,31,"Census Tract 6053, Camden County, New Jersey",0,0,0,0,0,65,33,523,175,698,211,386,1446,26,3,577,810,112,597,29
34007605400,0.8939264328485885,0.10607356715141146,214,0,1181,24,12,"Census Tract 6054, Camden County, New Jersey",0,32,11,91,28,39,13,792,253,1045,580,545,2197,34,22,406,1169,124,1125,56
34007605602,0.9729486023444545,0.027051397655545536,201,0,1441,33,55,"Census Tract 6056.02, Camden County, New Jersey",0,0,59,46,10,34,52,798,281,1079,548,893,2249,0,0,550,1109,30,1441,0
34007605700,0.9254327563249002,0.07456724367509987,395,0,1115,105,104,"Census Tract 6057, Camden County, New Jersey",0,0,97,54,0,79,165,1041,349,1390,413,642,2743,22,38,670,1502,112,1055,60
34007605800,0.9348370927318296,0.06516290726817042,70,0,1200,101,83,"Census Tract 6058, Camden County, New Jersey",0,0,0,0,9,42,19,1006,113,1119,534,574,2498,92,0,241,1197,78,1108,92
34007605900,0.9615754082612872,0.03842459173871278,121,0,1128,30,91,"Census Tract 6059, Camden County, New Jersey",0,0,27,0,6,21,67,867,134,1001,397,702,2461,29,0,288,1041,40,1099,29
34007606000,0.9582392776523702,0.0417607223476298,383,0,680,86,120,"Census Tract 6060, Camden County, New Jersey",0,35,22,162,48,32,84,543,306,849,372,258,1558,44,6,426,886,37,630,50
34007606100,0.9229857819905213,0.07701421800947868,157,0,628,9,142,"Census Tract 6061, Camden County, New Jersey",0,20,48,6,0,47,36,674,105,779,375,224,2045,6,23,230,844,65,599,29
34007606200,0.9239200515796261,0.07607994842037395,191,0,976,37,104,"Census Tract 6062, Camden County, New Jersey",0,0,40,77,28,0,46,1281,152,1433,441,511,3460,24,0,264,1551,118,952,24
34007606300,0.9650924024640657,0.03490759753593429,259,0,532,65,128,"Census Tract 6063, Camden County, New Jersey",0,26,54,16,11,80,72,668,272,940,214,288,1896,0,30,438,974,34,502,30
34007606400,0.9840674789128397,0.015932521087160263,48,0,851,48,209,"Census Tract 6064, Camden County, New Jersey",0,0,0,33,0,0,15,995,55,1050,462,382,2966,7,0,63,1067,17,844,7
34007606500,0.8983471074380165,0.10165289256198347,238,0,1273,113,114,"Census Tract 6065, Camden County, New Jersey",0,52,89,20,0,32,45,727,360,1087,389,750,2214,116,18,678,1210,123,1139,134
34007606600,0.974025974025974,0.025974025974025976,361,0,798,16,135,"Census Tract 6066, Camden County, New Jersey",0,100,0,16,63,149,33,604,371,975,237,510,1531,37,14,797,1001,26,747,51
34007606700,0.9399477806788512,0.06005221932114883,679,0,1776,133,212,"Census Tract 6067, Camden County, New Jersey",0,176,86,213,94,84,26,1134,666,1800,817,930,3321,29,0,1087,1915,115,1747,29
34007606800,0.8951559389515594,0.10484406104844061,171,0,1812,93,129,"Census Tract 6068, Camden County, New Jersey",0,44,39,0,6,16,66,1094,255,1349,850,962,3121,0,0,723,1507,158,1812,0
34007607000,0.9289050337311884,0.07109496626881162,463,0,1734,199,73,"Census Tract 6070, Camden County, New Jersey",0,31,86,123,7,48,168,832,958,1790,325,825,2146,239,345,2329,1927,137,1150,584
34007607100,1,0,118,0,1641,58,98,"Census Tract 6071, Camden County, New Jersey",0,10,32,0,0,46,30,1179,225,1404,456,1139,3318,46,0,591,1404,0,1595,46
34007607200,0.9093686354378818,0.09063136456211812,819,0,1155,169,32,"Census Tract 6072, Camden County, New Jersey",0,204,248,153,20,15,179,998,788,1786,359,716,2865,40,40,1536,1964,178,1075,80
34007607300,0.9511774842044802,0.048822515795519814,435,0.017805858701895463,1366,74,234,"Census Tract 6073, Camden County, New Jersey",31,62,79,98,87,81,28,1032,624,1656,632,693,2868,41,0,1408,1741,85,1325,41
34007607401,0.913469387755102,0.08653061224489796,395,0.008979591836734694,1064,131,66,"Census Tract 6074.01, Camden County, New Jersey",11,176,36,53,51,77,2,717,402,1119,620,409,2075,0,35,605,1225,106,1029,35
34007607402,0.8861087144089732,0.11389128559102675,230,0,1034,51,217,"Census Tract 6074.02, Camden County, New Jersey",0,93,20,55,47,4,11,772,255,1027,547,447,2151,30,10,571,1159,132,994,40
34007607502,0.9215943933420937,0.07840560665790626,304,0,1600,294,162,"Census Tract 6075.02, Camden County, New Jersey",0,0,58,230,0,16,0,1723,381,2104,702,898,4415,0,0,683,2283,179,1600,0
34007607503,0.9261658031088082,0.07383419689119171,379,0,1832,54,224,"Census Tract 6075.03, Camden County, New Jersey",0,40,42,182,106,0,9,1750,395,2145,1280,552,5287,0,0,815,2316,171,1832,0
34007607504,0.959425190194421,0.04057480980557904,7,0,1227,0,133,"Census Tract 6075.04, Camden County, New Jersey",0,0,0,0,0,0,7,1129,6,1135,816,411,3602,0,0,19,1183,48,1227,0
34007607505,0.9060446780551905,0.09395532194480946,9,0,1711,5,231,"Census Tract 6075.05, Camden County, New Jersey",0,0,0,9,0,0,0,1312,67,1379,977,722,4101,0,12,298,1522,143,1699,12
34007607506,0.9335239456754825,0.06647605432451752,712,0,566,63,199,"Census Tract 6075.06, Camden County, New Jersey",0,335,12,89,181,84,11,605,701,1306,133,372,1402,61,0,2057,1399,93,505,61
34007607507,0.8711980136561143,0.1288019863438858,2593,0,659,548,243,"Census Tract 6075.07, Camden County, New Jersey",0,665,407,746,449,234,92,788,2019,2807,338,302,2136,0,19,3368,3222,415,640,19
34007607600,0.9552795031055901,0.04472049689440994,3,0,1290,17,37,"Census Tract 6076, Camden County, New Jersey",0,0,0,0,3,0,0,722,47,769,512,751,1981,17,10,237,805,36,1263,27
34007607701,0.8216516308119362,0.17834836918806385,2242,0.005551700208188758,662,703,291,"Census Tract 6077.01, Camden County, New Jersey",16,860,322,151,517,256,136,524,1844,2368,169,244,1617,100,149,4494,2882,514,413,249
34007607702,0.8952850877192983,0.10471491228070176,999,0.013157894736842105,993,125,132,"Census Tract 6077.02, Camden County, New Jersey",24,195,112,367,160,100,65,736,897,1633,177,642,1942,161,13,1854,1824,191,819,174
34007607801,0.917470525187567,0.08252947481243302,1844,0,839,295,147,"Census Tract 6078.01, Camden County, New Jersey",0,501,348,85,652,183,75,972,1596,2568,257,474,2030,82,26,2994,2799,231,731,108
34007607802,0.9597457627118644,0.04025423728813559,119,0.007415254237288136,576,77,128,"Census Tract 6078.02, Camden County, New Jersey",7,57,0,17,38,0,7,655,251,906,243,333,1783,0,0,617,944,38,576,0
34007607900,0.92496765847348,0.07503234152652005,142,0,818,40,62,"Census Tract 6079, Camden County, New Jersey",0,48,4,14,18,19,39,571,144,715,390,386,1664,34,8,243,773,58,776,42
34007608001,0.8964357767316745,0.10356422326832548,528,0,1170,204,321,"Census Tract 6080.01, Camden County, New Jersey",0,168,175,92,53,16,24,819,514,1333,547,470,2282,133,20,1069,1487,154,1017,153
34007608202,0.9389002036659878,0.06109979633401222,272,0.02376103190767142,1552,81,45,"Census Tract 6082.02, Camden County, New Jersey",35,87,0,0,100,39,46,1182,201,1383,579,973,3433,0,0,443,1473,90,1552,0
34007608205,0.9929278642149929,0.007072135785007072,0,0,1960,24,33,"Census Tract 6082.05, Camden County, New Jersey",0,0,0,0,0,0,0,1338,66,1404,808,1119,3779,0,33,217,1414,10,1927,33
34007608206,0.9238805970149254,0.07611940298507462,69,0,1588,26,77,"Census Tract 6082.06, Camden County, New Jersey",0,10,24,27,0,0,8,1088,150,1238,673,830,2986,39,46,551,1340,102,1503,85
34007608209,0.9334239130434783,0.06657608695652174,619,0.021739130434782608,1123,306,47,"Census Tract 6082.09, Camden County, New Jersey",32,53,12,22,51,406,75,772,602,1374,404,685,2052,34,0,1286,1472,98,1089,34
34007608210,0.9464944649446494,0.05350553505535055,1168,0,687,104,74,"Census Tract 6082.10, Camden County, New Jersey",0,307,636,138,87,0,0,356,1183,1539,193,429,1073,48,17,2878,1626,87,622,65
34007608211,0.910814304179233,0.08918569582076691,812,0,1241,61,32,"Census Tract 6082.11, Camden County, New Jersey",0,266,138,53,14,169,172,1469,645,2114,588,588,4344,65,0,1504,2321,207,1176,65
34007608302,0.9449192782526116,0.055080721747388414,828,0,1154,277,33,"Census Tract 6083.02, Camden County, New Jersey",0,151,94,15,452,14,102,998,992,1990,47,1031,2491,60,16,1977,2106,116,1078,76
34007608303,0.835956917978459,0.164043082021541,403,0,1181,108,47,"Census Tract 6083.03, Camden County, New Jersey",0,85,56,10,69,80,103,610,399,1009,573,594,1748,14,0,948,1207,198,1167,14
34007608304,0.9135928961748634,0.08640710382513661,984,0,1757,124,153,"Census Tract 6083.04, Camden County, New Jersey",0,319,235,38,338,37,17,1854,821,2675,906,719,4274,96,36,1859,2928,253,1625,132
34007608401,0.9492647058823529,0.05073529411764706,0,0.022058823529411766,1603,10,71,"Census Tract 6084.01, Camden County, New Jersey",30,0,0,0,0,0,0,1246,45,1291,833,770,3853,0,0,224,1360,69,1603,0
34007608402,0.9781626506024096,0.021837349397590362,41,0.18298192771084337,1386,31,153,"Census Tract 6084.02, Camden County, New Jersey",243,14,0,0,0,0,27,1242,57,1299,1153,208,3838,25,0,117,1328,29,1361,25
34007608403,0.9815371404036067,0.0184628595963933,22,0,2134,54,99,"Census Tract 6084.03, Camden County, New Jersey",0,0,0,0,0,0,22,2034,252,2286,1226,908,6541,0,0,785,2329,43,2134,0
34007608404,0.9099099099099099,0.09009009009009009,215,0,1729,19,139,"Census Tract 6084.04, Camden County, New Jersey",0,18,0,0,44,58,95,1939,384,2323,1071,637,5134,21,0,1223,2553,230,1708,21
34007608503,0.8917881811204912,0.10821181887950883,529,0,945,88,55,"Census Tract 6085.03, Camden County, New Jersey",0,132,25,29,217,126,0,596,566,1162,605,281,1599,7,52,1096,1303,141,886,59
34007608504,0.923956546598056,0.07604345340194396,1284,0,593,231,32,"Census Tract 6085.04, Camden County, New Jersey",0,489,119,74,315,244,43,626,990,1616,343,200,1422,18,32,1937,1749,133,543,50
34007608600,0.9347604485219164,0.0652395514780836,728,0,1325,146,121,"Census Tract 6086, Camden County, New Jersey",0,292,75,96,180,72,13,1064,770,1834,718,579,3193,28,0,1718,1962,128,1297,28
34007608700,0.9764912280701754,0.023508771929824562,436,0,2459,234,158,"Census Tract 6087, Camden County, New Jersey",0,0,0,48,49,290,49,2403,380,2783,1364,956,6643,72,67,787,2850,67,2320,139
34007608800,0.931064958020327,0.068935041979673,463,0,2089,207,100,"Census Tract 6088, Camden County, New Jersey",0,81,0,18,139,149,76,1428,679,2107,608,1349,3677,17,115,1794,2263,156,1957,132
34007608901,0.9053364269141532,0.09466357308584687,290,0,1943,16,75,"Census Tract 6089.01, Camden County, New Jersey",0,16,0,0,44,30,200,1673,278,1951,1184,686,5195,73,0,586,2155,204,1870,73
34007608903,0.9267202859696158,0.07327971403038427,0,0,2006,16,22,"Census Tract 6089.03, Camden County, New Jersey",0,0,0,0,0,0,0,1007,30,1037,573,1433,3265,0,0,39,1119,82,2006,0
34007608904,0.9510357815442562,0.04896421845574388,16,0,855,0,29,"Census Tract 6089.04, Camden County, New Jersey",0,0,0,0,0,12,4,467,38,505,405,444,1333,6,0,81,531,26,849,6
34007609000,0.9186991869918699,0.08130081300813008,80,0.14471544715447154,632,45,41,"Census Tract 6090, Camden County, New Jersey",89,0,31,15,0,3,31,429,136,565,132,450,1128,13,37,298,615,50,582,50
34007609103,0.9031026252983294,0.09689737470167065,292,0.05250596658711217,1725,109,65,"Census Tract 6091.03, Camden County, New Jersey",110,126,53,11,32,41,29,1549,343,1892,1128,577,4171,20,0,953,2095,203,1705,20
34007609201,0.918334234721471,0.08166576527852894,425,0.02704164413196322,934,237,148,"Census Tract 6092.01, Camden County, New Jersey",50,209,12,91,60,0,53,1250,448,1698,521,318,3400,84,11,960,1849,151,839,95
34007609202,0.854388635210553,0.14561136478944697,347,0,1268,95,219,"Census Tract 6092.02, Camden County, New Jersey",0,25,10,52,56,113,91,1130,554,1684,535,532,3495,201,0,1428,1971,287,1067,201
34007609203,0.926919783043106,0.0730802169568941,334,0,2682,153,209,"Census Tract 6092.03, Camden County, New Jersey",0,89,38,44,69,58,36,2662,585,3247,2134,527,7958,21,0,1281,3503,256,2661,21
34007609204,0.8653968253968254,0.1346031746031746,393,0.11555555555555555,990,164,104,"Census Tract 6092.04, Camden County, New Jersey",182,148,6,22,140,22,55,825,538,1363,553,414,2485,0,23,1733,1575,212,967,23
34007609205,0.9031862745098039,0.09681372549019608,245,0,1586,89,160,"Census Tract 6092.05, Camden County, New Jersey",0,16,0,159,38,0,32,1781,430,2211,554,953,5109,50,29,844,2448,237,1507,79
34007610300,0.8446428571428571,0.15535714285714286,784,0,149,306,59,"Census Tract 6103, Camden County, New Jersey",0,17,72,606,10,71,8,147,799,946,14,90,317,45,0,1387,1120,174,104,45
34007610400,0.8078155028827675,0.19218449711723254,532,0,525,476,155,"Census Tract 6104, Camden County, New Jersey",0,40,30,61,0,148,253,580,681,1261,213,286,1484,26,0,1915,1561,300,499,26
34007610500,0.9053461875547765,0.09465381244522349,319,0,2541,109,269,"Census Tract 6105, Camden County, New Jersey",0,11,41,20,65,0,182,1590,476,2066,1493,1009,5578,39,0,1972,2282,216,2502,39
34007610600,0.8389715832205683,0.16102841677943167,505,0.20162381596752368,207,134,76,"Census Tract 6106, Camden County, New Jersey",149,7,16,451,5,4,22,126,494,620,23,47,283,70,67,746,739,119,70,137
34007610800,0.8858560794044665,0.1141439205955335,187,0.03225806451612903,798,188,46,"Census Tract 6108, Camden County, New Jersey",39,20,0,102,0,8,57,861,210,1071,202,577,2410,19,0,286,1209,138,779,19
34007610900,0.9662556781310837,0.03374432186891629,313,0,1648,143,81,"Census Tract 6109, Camden County, New Jersey",0,0,40,73,4,45,151,752,737,1489,820,502,2073,181,145,1266,1541,52,1322,326
34007611000,0.9302925989672978,0.06970740103270223,422,0,1673,286,148,"Census Tract 6110, Camden County, New Jersey",0,23,15,97,48,12,227,1236,926,2162,678,928,3251,19,48,3017,2324,162,1606,67
34007611100,0.9575289575289575,0.04247104247104247,461,0.009266409266409266,1072,123,10,"Census Tract 6111, Camden County, New Jersey",12,297,55,82,0,27,0,744,496,1240,308,723,2053,12,29,1028,1295,55,1031,41
34007611200,0.943630214205186,0.05636978579481398,351,0,1828,28,156,"Census Tract 6112, Camden County, New Jersey",0,89,0,59,107,55,41,1308,366,1674,846,943,3633,33,6,837,1774,100,1789,39
34007611300,0.9177295918367347,0.08227040816326531,308,0.002551020408163265,1824,163,66,"Census Tract 6113, Camden County, New Jersey",4,76,32,21,0,0,179,1079,360,1439,518,1188,2781,0,118,939,1568,129,1706,118
34007611400,0.9128491620111732,0.08715083798882682,63,0,2037,114,97,"Census Tract 6114, Camden County, New Jersey",0,0,0,19,38,0,6,1474,160,1634,1041,996,3850,0,0,504,1790,156,2037,0
34007611500,0.9195842450765864,0.08041575492341356,149,0,2136,74,63,"Census Tract 6115, Camden County, New Jersey",0,0,0,0,48,19,82,1516,165,1681,1099,955,3983,48,34,347,1828,147,2054,82
34007611600,0.8521551724137931,0.1478448275862069,1651,0,528,459,452,"Census Tract 6116, Camden County, New Jersey",0,86,118,1093,115,101,138,409,1568,1977,93,386,1195,49,0,2741,2320,343,479,49
34007611700,0.9040529363110008,0.09594706368899918,180,0,1093,121,113,"Census Tract 6117, Camden County, New Jersey",0,0,55,37,7,59,22,826,267,1093,407,646,2423,24,16,595,1209,116,1053,40
34009020101,0.3706462653513187,0.6293537346486813,2318,0.0014093013891685123,1141,234,23,"Census Tract 201.01, Cape May County, New Jersey",7,249,303,239,211,428,888,1056,785,1841,299,611,2108,76,155,1823,4967,3126,910,231
34009020102,0.26622210823288023,0.7337778917671198,1414,0,803,104,6,"Census Tract 201.02, Cape May County, New Jersey",0,174,185,336,67,172,480,710,328,1038,541,213,1613,43,6,541,3899,2861,754,49
34009020201,0.3888506538196834,0.6111493461803166,201,0,579,11,23,"Census Tract 202.01, Cape May County, New Jersey",0,0,0,0,20,31,150,484,81,565,338,229,1171,4,8,282,1453,888,567,12
34009020203,0.2408153590898317,0.7591846409101682,701,0,634,176,0,"Census Tract 202.03, Cape May County, New Jersey",0,51,12,210,105,51,272,692,324,1016,360,224,1449,50,0,474,4219,3203,584,50
34009020205,0.12163814180929096,0.878361858190709,425,0,275,30,5,"Census Tract 202.05, Cape May County, New Jersey",0,15,5,0,41,47,317,349,49,398,137,110,626,5,23,74,3272,2874,247,28
34009020206,0.17781690140845072,0.8221830985915493,526,0,239,20,0,"Census Tract 202.06, Cape May County, New Jersey",0,113,44,8,73,84,204,318,86,404,163,76,661,0,0,198,2272,1868,239,0
34009020301,0.7230646448523543,0.27693535514764567,50,0.27773343974461295,1872,25,1,"Census Tract 203.01, Cape May County, New Jersey",696,0,0,0,7,7,36,1614,198,1812,883,959,4025,7,23,454,2506,694,1842,30
34009020302,0.6530833032816444,0.34691669671835557,52,0.24738550306527227,2002,94,23,"Census Tract 203.02, Cape May County, New Jersey",686,0,0,0,11,20,21,1661,150,1811,1277,725,4229,0,0,246,2773,962,2002,0
34009020400,0.9285127362366475,0.0714872637633525,32,0,1249,41,23,"Census Tract 204, Cape May County, New Jersey",0,0,0,0,0,0,32,931,199,1130,715,449,2513,85,0,427,1217,87,1164,85
34009020500,0.6919758412424504,0.3080241587575496,184,0.28731665228645387,568,97,31,"Census Tract 205, Cape May County, New Jersey",333,64,37,9,10,32,32,452,350,802,207,240,1064,18,103,951,1159,357,447,121
34009020600,0.922497308934338,0.077502691065662,0,0.005382131324004306,904,3,5,"Census Tract 206, Cape May County, New Jersey",5,0,0,0,0,0,0,740,117,857,291,613,1745,0,0,426,929,72,904,0
34009020700,0.7715355805243446,0.22846441947565543,8,0,1890,39,0,"Census Tract 207, Cape May County, New Jersey",0,0,0,8,0,0,0,1293,149,1442,1110,760,3297,20,0,619,1869,427,1870,20
34009020800,0.14812663374963694,0.851873366250363,1625,0,621,78,7,"Census Tract 208, Cape May County, New Jersey",0,274,209,164,219,101,658,913,107,1020,413,204,1709,0,4,241,6886,5866,617,4
34009020901,0.14546619673181674,0.8545338032681833,384,0,374,18,18,"Census Tract 209.01, Cape May County, New Jersey",0,48,25,32,54,35,190,412,42,454,205,156,854,7,6,96,3121,2667,361,13
34009020902,0.1343645173313455,0.8656354826686545,465,0.0016772269847185985,595,37,9,"Census Tract 209.02, Cape May County, New Jersey",9,49,104,18,70,74,150,664,57,721,259,320,1310,11,5,94,5366,4645,579,16
34009021001,0.637213254035684,0.36278674596431604,132,0,511,35,17,"Census Tract 210.01, Cape May County, New Jersey",0,0,5,0,85,42,0,600,150,750,361,150,1426,0,0,309,1177,427,511,0
34009021002,0.8374603174603175,0.16253968253968254,0,0.06095238095238095,1187,69,5,"Census Tract 210.02, Cape May County, New Jersey",96,0,0,0,0,0,0,1182,137,1319,718,419,3125,38,12,391,1575,256,1137,50
34009021100,0.7746741154562383,0.22532588454376165,264,0.08156424581005586,1264,107,0,"Census Tract 211, Cape May County, New Jersey",219,0,0,35,17,12,200,1526,554,2080,600,664,3654,0,0,912,2685,605,1264,0
34009021300,0.22491506228765573,0.7750849377123443,2334,0.0016987542468856172,1878,87,0,"Census Tract 213, Cape May County, New Jersey",15,281,202,311,301,410,829,1665,321,1986,1006,872,3325,0,0,524,8830,6844,1878,0
34009021400,0.2959830866807611,0.7040169133192389,2438,0.0010570824524312897,758,332,37,"Census Tract 214, Cape May County, New Jersey",6,140,61,143,585,927,582,824,856,1680,329,371,1888,39,19,1796,5676,3996,700,58
34009021500,0.37818336162988114,0.6218166383701188,786,0,311,204,43,"Census Tract 215, Cape May County, New Jersey",0,70,43,108,104,156,305,486,405,891,115,189,1074,7,0,640,2356,1465,304,7
34009021600,0.25652484805148373,0.7434751519485163,1143,0,1185,55,43,"Census Tract 216, Cape May County, New Jersey",0,100,78,126,158,195,486,1055,380,1435,603,518,2377,44,20,754,5594,4159,1121,64
34009021701,0.8280346820809249,0.17196531791907516,366,0.008670520231213872,1067,179,17,"Census Tract 217.01, Cape May County, New Jersey",12,18,36,232,0,69,11,801,345,1146,409,646,1998,0,12,551,1384,238,1055,12
34009021702,0.43568147013782543,0.5643185298621746,245,0.12519142419601836,995,33,1,"Census Tract 217.02, Cape May County, New Jersey",327,8,23,96,25,15,78,972,166,1138,513,451,2139,22,9,262,2612,1474,964,31
34009021803,0.5553941155103523,0.44460588448964766,71,0,1007,183,0,"Census Tract 218.03, Cape May County, New Jersey",0,0,40,0,0,0,31,1283,246,1529,521,439,2519,9,38,503,2753,1224,960,47
34009021804,0.7066744730679156,0.2933255269320843,136,0,1766,97,51,"Census Tract 218.04, Cape May County, New Jersey",0,0,0,0,47,47,42,1867,547,2414,1156,598,4377,12,0,1384,3416,1002,1754,12
34009021805,0.737649063032368,0.262350936967632,55,0.022146507666098807,1616,143,87,"Census Tract 218.05, Cape May County, New Jersey",52,8,9,9,10,11,8,1524,208,1732,821,749,3744,27,19,558,2348,616,1570,46
34009021806,0.5439889451865499,0.45601105481345,180,0,1028,108,40,"Census Tract 218.06, Cape May County, New Jersey",0,112,9,23,0,25,11,979,202,1181,398,630,2184,0,0,517,2171,990,1028,0
34009021900,0.4373297002724796,0.5626702997275205,101,0.049954586739327886,887,43,17,"Census Tract 219, Cape May County, New Jersey",110,0,0,0,35,17,49,806,157,963,405,458,1770,21,3,430,2202,1239,863,24
34009022000,0.33097595473833097,0.669024045261669,902,0,799,175,21,"Census Tract 220, Cape May County, New Jersey",0,101,0,249,157,258,137,881,523,1404,336,414,1601,17,32,1234,4242,2838,750,49
34009022101,0.8099878197320342,0.1900121802679659,24,0,339,34,11,"Census Tract 221.01, Cape May County, New Jersey",0,13,0,7,0,0,4,556,109,665,152,174,1369,13,0,231,821,156,326,13
34009022102,0.6692104490754329,0.3307895509245671,291,0.21837393601408864,1061,123,144,"Census Tract 221.02, Cape May County, New Jersey",744,116,0,0,56,19,100,1664,616,2280,426,489,3506,120,26,2752,3407,1127,915,146
34009990100,NaN,NaN,0,NaN,0,0,0,"Census Tract 9901, Cape May County, New Jersey",0,0,0,0,0,0,0,0,0,0,0,0,0,0,0,0,0,0,0,0
34011010101,0.8003220611916264,0.1996779388083736,8,0.08132045088566828,1372,35,22,"Census Tract 101.01, Cumberland County, New Jersey",101,0,0,0,0,0,8,890,104,994,530,834,2220,8,0,261,1242,248,1364,8
34011010103,NaN,NaN,0,NaN,0,0,0,"Census Tract 101.03, Cumberland County, New Jersey",0,0,0,0,0,0,0,0,0,0,0,0,0,0,0,0,0,0,0,0
34011010200,0.863244176013805,0.13675582398619499,24,0.24029335634167387,1289,105,32,"Census Tract 102, Cumberland County, New Jersey",557,5,0,0,8,0,11,1392,609,2001,691,525,3196,73,0,1806,2318,317,1216,73
34011010301,0.8438855160450998,0.15611448395490027,11,0.010407632263660017,1279,35,24,"Census Tract 103.01, Cumberland County, New Jersey",12,0,0,0,0,0,11,803,170,973,769,416,2422,81,13,693,1153,180,1185,94
34011010302,0.5700365408038977,0.4299634591961023,22,0.1705237515225335,456,28,0,"Census Tract 103.02, Cumberland County, New Jersey",140,0,0,0,1,0,21,365,103,468,142,289,910,15,10,267,821,353,431,25
34011010401,0.8736479842674533,0.1263520157325467,80,0.15634218289085547,2290,107,81,"Census Tract 104.01, Cumberland County, New Jersey",318,0,0,0,7,16,57,1333,444,1777,895,1250,3828,43,102,1191,2034,257,2145,145
34011010402,NaN,NaN,0,NaN,0,0,0,"Census Tract 104.02, Cumberland County, New Jersey",0,0,0,0,0,0,0,0,0,0,0,0,0,0,0,0,0,0,0,0
34011010500,0.8770270270270271,0.12297297297297298,6,0.021621621621621623,758,20,2,"Census Tract 105, Cumberland County, New Jersey",16,0,0,0,2,2,2,533,116,649,213,504,1338,10,31,323,740,91,717,41
34011010600,0.926690758905524,0.073309241094476,195,0.016520392359318535,2171,58,19,"Census Tract 106, Cumberland County, New Jersey",32,0,49,42,26,18,60,1439,356,1795,896,1083,3712,159,33,793,1937,142,1979,192
34011010700,0.9419795221843004,0.05802047781569966,271,0,2542,159,28,"Census Tract 107, Cumberland County, New Jersey",0,13,39,32,96,91,0,2119,641,2760,1028,1440,5782,0,74,1613,2930,170,2468,74
34011010800,0.9307359307359307,0.06926406926406926,79,0,1439,26,14,"Census Tract 108, Cumberland County, New Jersey",0,0,4,0,0,25,50,878,197,1075,552,778,2455,19,90,512,1155,80,1330,109
34011020100,0.8801020408163265,0.11989795918367346,244,0,144,164,52,"Census Tract 201, Cumberland County, New Jersey",0,0,9,67,15,20,133,26,319,345,71,0,124,32,41,972,392,47,71,73
34011020200,0.8768699654775605,0.12313003452243959,486,0,118,189,22,"Census Tract 202, Cumberland County, New Jersey",0,15,30,97,0,165,179,124,638,762,15,74,516,29,0,2369,869,107,89,29
34011020300,0.8936052921719956,0.1063947078280044,671,0,545,454,106,"Census Tract 203, Cumberland County, New Jersey",0,16,14,0,22,141,478,389,1232,1621,367,148,1467,0,30,4939,1814,193,515,30
34011020400,0.9060283687943262,0.09397163120567376,244,0,462,87,0,"Census Tract 204, Cumberland County, New Jersey",0,21,20,32,59,51,61,481,541,1022,155,287,1357,8,12,1921,1128,106,442,20
34011020502,NaN,NaN,0,NaN,0,0,0,"Census Tract 205.02, Cumberland County, New Jersey",0,0,0,0,0,0,0,0,0,0,0,0,0,0,0,0,0,0,0,0
34011020503,0.7821350762527233,0.2178649237472767,528,0.00944081336238199,563,314,82,"Census Tract 205.03, Cumberland County, New Jersey",13,74,23,138,144,65,84,359,718,1077,189,261,1051,24,89,2580,1377,300,450,113
34011020600,0.9650571791613723,0.0349428208386277,497,0,887,143,0,"Census Tract 206, Cumberland County, New Jersey",0,153,12,29,65,22,216,888,631,1519,324,542,2705,11,10,1209,1574,55,866,21
34011030100,0.8173758865248227,0.18262411347517732,448,0,17,171,8,"Census Tract 301, Cumberland County, New Jersey",0,19,95,94,45,82,113,43,418,461,0,0,128,17,0,826,564,103,0,17
34011030200,0.7615643397813289,0.23843566021867116,789,0,1097,298,81,"Census Tract 302, Cumberland County, New Jersey",0,0,15,237,94,99,344,987,824,1811,451,596,2518,50,0,2013,2378,567,1047,50
34011030300,0.8549042367962856,0.14509576320371445,725,0,703,303,27,"Census Tract 303, Cumberland County, New Jersey",0,119,59,112,106,90,239,569,904,1473,281,380,1336,15,27,2120,1723,250,661,42
34011030400,0.9358711566617862,0.06412884333821377,1062,0,2457,337,0,"Census Tract 304, Cumberland County, New Jersey",0,343,248,180,212,37,42,1938,1258,3196,1375,1017,4916,65,0,3176,3415,219,2392,65
34011030501,0.9038970866439652,0.09610291335603481,36,0.07907680665909951,2143,118,49,"Census Tract 305.01, Cumberland County, New Jersey",209,0,15,0,21,0,0,2104,285,2389,880,1263,5530,0,0,855,2643,254,2143,0
34011030502,0.9604952830188679,0.039504716981132074,248,0.05365566037735849,1235,138,10,"Census Tract 305.02, Cumberland County, New Jersey",91,151,13,0,54,14,16,1170,459,1629,470,744,3080,0,21,1191,1696,67,1214,21
34011040300,0.9019987105093488,0.09800128949065119,556,0,837,131,34,"Census Tract 403, Cumberland County, New Jersey",0,24,22,234,64,64,148,718,681,1399,352,397,2050,68,20,1404,1551,152,749,88
34011040400,0.9374437443744374,0.06255625562556255,452,0,2211,135,57,"Census Tract 404, Cumberland County, New Jersey",0,9,0,78,63,0,302,1481,602,2083,943,1214,5184,54,0,1486,2222,139,2157,54
34011040500,0.9707057256990679,0.02929427430093209,1005,0,1541,373,0,"Census Tract 405, Cumberland County, New Jersey",0,176,118,156,241,156,158,996,1191,2187,496,627,2950,323,95,3335,2253,66,1123,418
34011040600,0.9603960396039604,0.039603960396039604,829,0.00456968773800457,1798,350,29,"Census Tract 406, Cumberland County, New Jersey",12,227,130,115,107,103,147,1492,1030,2522,576,1037,4365,137,48,2450,2626,104,1613,185
34011040700,0.8724373576309795,0.1275626423690205,731,0,1762,286,44,"Census Tract 407, Cumberland County, New Jersey",0,103,58,243,164,69,94,1957,724,2681,780,924,5162,58,0,2066,3073,392,1704,58
34011040800,0.9479054779806659,0.05209452201933405,114,0,1818,65,55,"Census Tract 408, Cumberland County, New Jersey",0,67,0,32,15,0,0,1562,203,1765,865,953,4592,0,0,531,1862,97,1818,0
34011040901,0.8935622317596567,0.10643776824034334,42,0.04721030042918455,1363,62,16,"Census Tract 409.01, Cumberland County, New Jersey",55,0,0,10,32,0,0,888,153,1041,281,967,2412,27,88,517,1165,124,1248,115
34011040902,0.9157774390243902,0.08422256097560976,127,0.3018292682926829,1740,92,0,"Census Tract 409.02, Cumberland County, New Jersey",792,0,0,22,0,0,105,1743,660,2403,786,916,4049,38,0,1993,2624,221,1702,38
34011041000,0.9866484080794249,0.013351591920575145,177,0.2844916124614858,1848,78,137,"Census Tract 410, Cumberland County, New Jersey",831,0,0,0,60,0,117,2378,504,2882,816,1032,6696,0,0,1244,2921,39,1848,0
34011041100,0.82907133243607,0.17092866756393002,1078,0,557,327,114,"Census Tract 411, Cumberland County, New Jersey",0,0,13,0,112,399,554,557,1291,1848,299,152,2173,73,33,3513,2229,381,451,106
34011990000,NaN,NaN,0,NaN,0,0,0,"Census Tract 9900, Cumberland County, New Jersey",0,0,0,0,0,0,0,0,0,0,0,0,0,0,0,0,0,0,0,0
34013000100,0.940923317683881,0.059076682316118935,1991,0,1629,492,258,"Census Tract 1, Essex County, New Jersey",0,346,180,268,88,622,487,823,1582,2405,699,301,2553,393,236,4319,2556,151,1000,629
34013000200,0.9592326139088729,0.0407673860911271,1135,0,468,465,341,"Census Tract 2, Essex County, New Jersey",0,104,64,293,60,432,182,276,924,1200,221,156,916,84,7,2550,1251,51,377,91
34013000300,0.9280618311533888,0.07193816884661118,1474,0,732,980,574,"Census Tract 3, Essex County, New Jersey",0,125,27,552,288,152,330,192,1369,1561,402,117,755,166,47,2961,1682,121,519,213
34013000400,0.8805104408352669,0.11948955916473318,753,0,301,236,167,"Census Tract 4, Essex County, New Jersey",0,36,23,8,13,266,407,175,584,759,69,87,511,80,65,1406,862,103,156,145
34013000500,0.931782945736434,0.06821705426356589,542,0,481,257,230,"Census Tract 5, Essex County, New Jersey",0,51,0,0,147,219,125,208,393,601,265,119,709,85,12,1138,645,44,384,97
34013000600,0.9498941425546931,0.05010585744530699,1161,0,1296,188,338,"Census Tract 6, Essex County, New Jersey",0,50,13,11,64,726,297,463,883,1346,672,391,1716,175,58,2063,1417,71,1063,233
34013000700,0.8367664205207929,0.16323357947920716,2309,0,778,711,711,"Census Tract 7, Essex County, New Jersey",0,112,271,424,182,918,402,348,1805,2153,645,0,1747,103,30,5179,2573,420,645,133
34013000800,0.8659295093296475,0.13407049067035245,1222,0,894,373,317,"Census Tract 8, Essex County, New Jersey",0,64,0,22,104,633,399,344,909,1253,437,228,1535,132,97,2854,1447,194,665,229
34013000900,0.6804511278195489,0.31954887218045114,1424,0,803,491,246,"Census Tract 9, Essex County, New Jersey",0,30,25,604,22,346,397,149,937,1086,0,491,576,262,50,2699,1596,510,491,312
34013001000,0.8376139188069595,0.1623860811930406,1120,0,224,456,251,"Census Tract 10, Essex County, New Jersey",0,33,127,218,67,494,181,147,864,1011,43,15,446,86,80,2252,1207,196,58,166
34013001100,0.9657320872274143,0.03426791277258567,321,0,256,162,174,"Census Tract 11, Essex County, New Jersey",0,0,14,61,13,176,57,265,355,620,149,51,649,26,30,1157,642,22,200,56
34013001300,0.799163179916318,0.200836820083682,455,0,240,282,236,"Census Tract 13, Essex County, New Jersey",0,0,0,0,17,283,155,114,459,573,11,108,492,83,38,1055,717,144,119,121
34013001400,0.7002360346184107,0.2997639653815893,1034,0,446,303,387,"Census Tract 14, Essex County, New Jersey",0,25,0,0,82,532,395,270,620,890,81,202,854,126,37,1820,1271,381,283,163
34013001500,0.8294679399727148,0.17053206002728513,511,0,76,407,261,"Census Tract 15, Essex County, New Jersey",0,18,0,295,0,155,43,42,566,608,5,12,90,36,23,1609,733,125,17,59
34013001600,0.7670299727520435,0.2329700272479564,626,0,102,212,184,"Census Tract 16, Essex County, New Jersey",0,0,70,81,10,285,180,157,406,563,7,65,639,30,0,1147,734,171,72,30
34013001700,0.792694965449161,0.2073050345508391,925,0,426,359,390,"Census Tract 17, Essex County, New Jersey",0,14,29,13,7,610,252,178,625,803,119,21,602,269,17,1813,1013,210,140,286
34013001800,0.7628979143798024,0.23710208562019758,686,0.010976948408342482,152,232,300,"Census Tract 18, Essex County, New Jersey",10,23,0,7,38,403,215,165,530,695,86,0,530,66,0,1631,911,216,86,66
34013001900,0.7685851318944844,0.2314148681055156,693,0,354,327,223,"Census Tract 19, Essex County, New Jersey",0,158,76,20,146,192,101,114,527,641,91,137,399,74,52,1470,834,193,228,126
34013002000,0.8428940568475453,0.15710594315245477,1533,0,937,640,417,"Census Tract 20, Essex County, New Jersey",0,77,36,290,99,577,454,439,1192,1631,354,484,1430,58,41,2763,1935,304,838,99
34013002100,0.8379705400981997,0.16202945990180032,809,0,1326,163,225,"Census Tract 21, Essex County, New Jersey",0,23,48,0,0,322,416,556,468,1024,495,597,1993,56,178,1274,1222,198,1092,234
34013002201,0.7835990888382688,0.2164009111617312,3546,0,1741,1191,833,"Census Tract 22.01, Essex County, New Jersey",0,174,179,2577,15,178,423,291,2805,3096,243,194,962,1160,144,8398,3951,855,437,1304
34013002202,0.9366438356164384,0.06335616438356165,682,0,1049,216,112,"Census Tract 22.02, Essex County, New Jersey",0,44,0,40,0,360,238,639,455,1094,367,453,1801,179,50,1526,1168,74,820,229
34013002300,0.8891921397379913,0.11080786026200873,1187,0.009279475982532752,1989,312,481,"Census Tract 23, Essex County, New Jersey",17,184,32,16,78,409,468,849,780,1629,999,791,3163,169,30,1913,1832,203,1790,199
34013002400,0.7568345323741007,0.24316546762589927,1036,0.017985611510791366,769,423,265,"Census Tract 24, Essex County, New Jersey",25,28,0,0,101,585,322,344,708,1052,293,327,894,44,105,1781,1390,338,620,149
34013002500,0.7710843373493976,0.2289156626506024,1297,0,530,199,260,"Census Tract 25, Essex County, New Jersey",0,0,27,0,66,762,442,348,868,1216,288,77,1026,37,128,2880,1577,361,365,165
34013002600,0.7296296296296296,0.27037037037037037,701,0,54,274,137,"Census Tract 26, Essex County, New Jersey",0,48,29,0,84,375,165,41,550,591,0,45,78,0,9,1544,810,219,45,9
34013002800,0.808868501529052,0.191131498470948,451,0,522,150,156,"Census Tract 28, Essex County, New Jersey",0,15,0,7,69,230,130,171,358,529,346,52,547,124,0,1126,654,125,398,124
34013003100,0.9719387755102041,0.02806122448979592,379,0,136,276,248,"Census Tract 31, Essex County, New Jersey",0,9,97,63,34,97,79,168,594,762,0,22,561,114,0,1631,784,22,22,114
34013003500,0.7776628748707343,0.22233712512926576,739,0.007238883143743537,440,244,179,"Census Tract 35, Essex County, New Jersey",7,0,0,0,84,382,273,263,489,752,144,164,742,48,84,1330,967,215,308,132
34013003700,0.7296703296703296,0.2703296703296703,791,0,231,228,149,"Census Tract 37, Essex County, New Jersey",0,8,35,0,13,415,320,162,502,664,22,122,338,13,74,1482,910,246,144,87
34013003800,0.8127753303964758,0.18722466960352424,509,0.006607929515418502,634,249,176,"Census Tract 38, Essex County, New Jersey",6,0,0,17,80,142,270,400,338,738,359,242,1305,7,26,908,908,170,601,33
34013003900,0.8547904191616766,0.14520958083832336,534,0,224,380,269,"Census Tract 39, Essex County, New Jersey",0,35,59,281,37,88,34,37,534,571,40,5,57,126,53,1247,668,97,45,179
34013004100,0.7916992952231793,0.20830070477682067,996,0,522,512,174,"Census Tract 41, Essex County, New Jersey",0,73,9,66,30,610,208,230,781,1011,131,229,724,22,140,2167,1277,266,360,162
34013004200,0.6616989567809239,0.338301043219076,931,0,402,274,378,"Census Tract 42, Essex County, New Jersey",0,34,80,34,17,365,401,206,682,888,186,126,591,0,90,1550,1342,454,312,90
34013004300,0.7672849915682968,0.2327150084317032,1007,0,325,360,393,"Census Tract 43, Essex County, New Jersey",0,59,35,6,16,539,352,164,746,910,59,148,443,80,38,2181,1186,276,207,118
34013004400,0.5955334987593052,0.4044665012406948,678,0,313,174,213,"Census Tract 44, Essex County, New Jersey",0,30,40,15,33,237,323,87,393,480,57,101,272,121,34,1068,806,326,158,155
34013004500,0.8098591549295775,0.19014084507042253,1103,0,856,285,426,"Census Tract 45, Essex County, New Jersey",0,19,106,47,128,559,244,335,815,1150,94,455,1014,44,263,2198,1420,270,549,307
34013004600,0.7613559322033898,0.23864406779661018,1117,0,1057,270,310,"Census Tract 46, Essex County, New Jersey",0,141,130,0,79,556,211,425,698,1123,196,603,1139,0,258,1590,1475,352,799,258
34013004700,0.9090909090909091,0.09090909090909091,1611,0,1910,494,637,"Census Tract 47, Essex County, New Jersey",0,108,246,283,41,590,343,515,1395,1910,347,821,1887,303,439,3245,2101,191,1168,742
34013004801,0.8771610555050046,0.12283894449499545,930,0.02456778889899909,578,373,421,"Census Tract 48.01, Essex County, New Jersey",27,30,139,559,15,39,148,136,828,964,207,40,449,231,100,1826,1099,135,247,331
34013004802,0.7382947264662395,0.2617052735337605,1708,0,302,1011,198,"Census Tract 48.02, Essex County, New Jersey",0,42,160,925,191,183,207,103,1395,1498,0,38,176,180,84,2806,2029,531,38,264
34013004900,0.8077790304396844,0.19222096956031567,1437,0,703,437,301,"Census Tract 49, Essex County, New Jersey",0,15,173,323,18,562,346,342,1091,1433,119,332,1182,135,117,2312,1774,341,451,252
34013005000,0.7545787545787546,0.2454212454212454,950,0,196,399,327,"Census Tract 50, Essex County, New Jersey",0,52,35,118,65,517,163,203,827,1030,0,159,652,37,0,2151,1365,335,159,37
34013005100,0.7553398058252427,0.2446601941747573,859,0,695,146,137,"Census Tract 51, Essex County, New Jersey",0,60,0,0,22,672,105,296,482,778,143,345,757,59,148,1379,1030,252,488,207
34013005200,0.7677902621722846,0.23220973782771537,348,0.018726591760299626,240,195,274,"Census Tract 52, Essex County, New Jersey",10,26,0,0,62,152,108,133,277,410,19,171,371,50,0,1030,534,124,190,50
34013005300,0.767572633552015,0.232427366447985,844,0,405,352,342,"Census Tract 53, Essex County, New Jersey",0,91,9,0,53,458,233,165,654,819,208,80,549,63,54,1572,1067,248,288,117
34013005400,0.7600690448791715,0.23993095512082854,1507,0,448,810,624,"Census Tract 54, Essex County, New Jersey",0,154,117,235,180,597,224,94,1227,1321,0,41,400,339,68,3752,1738,417,41,407
34013005700,0.8560079443892751,0.14399205561072492,807,0,244,312,317,"Census Tract 57, Essex County, New Jersey",0,49,65,0,27,442,224,166,696,862,37,117,463,64,26,1923,1007,145,154,90
34013006200,0.9359145527369827,0.06408544726301736,484,0,129,274,190,"Census Tract 62, Essex County, New Jersey",0,73,98,66,201,46,0,107,594,701,4,0,255,47,78,1328,749,48,4,125
34013006400,0.9005328596802842,0.0994671403197158,82,0,404,61,89,"Census Tract 64, Essex County, New Jersey",0,5,6,47,5,0,19,408,99,507,387,17,938,0,0,161,563,56,404,0
34013006600,0.9637883008356546,0.036211699164345405,593,0,101,197,154,"Census Tract 66, Essex County, New Jersey",0,97,133,59,232,52,20,32,660,692,0,20,120,62,19,1227,718,26,20,81
34013006700,0.9451401311866429,0.054859868813357186,1560,0,471,1049,310,"Census Tract 67, Essex County, New Jersey",0,195,260,604,15,329,157,98,1487,1585,0,11,670,460,0,2994,1677,92,11,460
34013006800,0.9201406328478152,0.07985936715218483,1795,0,508,416,519,"Census Tract 68, Essex County, New Jersey",0,128,22,221,323,562,539,385,1447,1832,317,50,1609,74,67,3952,1991,159,367,141
34013006900,0.9533291848164281,0.04667081518357187,1408,0,832,580,597,"Census Tract 69, Essex County, New Jersey",0,65,46,0,449,415,433,302,1230,1532,260,241,1013,261,70,3840,1607,75,501,331
34013007000,0.9830371567043619,0.016962843295638127,1141,0,522,432,325,"Census Tract 70, Essex County, New Jersey",0,90,81,0,221,416,333,184,1033,1217,119,316,587,58,29,2859,1238,21,435,87
34013007100,0.9202049780380673,0.07979502196193265,1266,0,788,193,157,"Census Tract 71, Essex County, New Jersey",0,134,7,0,175,438,512,523,734,1257,238,426,1699,42,82,2343,1366,109,664,124
34013007200,0.917037037037037,0.08296296296296296,1184,0,479,350,507,"Census Tract 72, Essex County, New Jersey",0,0,0,0,99,750,335,280,958,1238,74,138,929,188,79,2894,1350,112,212,267
34013007300,0.9660493827160493,0.033950617283950615,1698,0,1331,579,483,"Census Tract 73, Essex County, New Jersey",0,36,46,23,177,896,520,580,1298,1878,509,344,1842,307,171,3871,1944,66,853,478
34013007400,0.9040959040959041,0.0959040959040959,842,0,458,292,192,"Census Tract 74, Essex County, New Jersey",0,51,0,0,103,330,358,257,648,905,180,133,775,63,82,2027,1001,96,313,145
34013007501,0.9297544260422616,0.07024557395773844,1586,0.006853226727584237,482,950,585,"Census Tract 75.01, Essex County, New Jersey",12,174,155,105,344,503,305,135,1493,1628,88,92,450,68,234,4166,1751,123,180,302
34013007502,0.8537782139352306,0.14622178606476938,926,0,295,412,134,"Census Tract 75.02, Essex County, New Jersey",0,0,14,0,381,309,222,117,753,870,30,59,321,141,65,2295,1019,149,89,206
34013007600,0.9360323886639677,0.06396761133603239,1235,0,640,575,473,"Census Tract 76, Essex County, New Jersey",0,116,66,0,146,406,501,196,960,1156,249,158,696,121,112,2643,1235,79,407,233
34013007700,0.960377358490566,0.03962264150943396,920,0,324,437,271,"Census Tract 77, Essex County, New Jersey",0,88,30,0,166,345,291,226,792,1018,50,95,594,150,29,2149,1060,42,145,179
34013007800,0.9575435936315391,0.04245640636846096,1095,0,846,518,342,"Census Tract 78, Essex County, New Jersey",0,42,0,0,172,687,194,320,943,1263,241,264,1027,299,42,3049,1319,56,505,341
34013007900,0.9312714776632303,0.06872852233676977,1500,0,768,868,811,"Census Tract 79, Essex County, New Jersey",0,263,102,45,316,521,253,311,1315,1626,47,225,554,102,394,3331,1746,120,272,496
34013008000,0.9444444444444444,0.05555555555555555,1001,0,375,427,481,"Census Tract 80, Essex County, New Jersey",0,13,103,471,49,286,79,225,778,1003,14,111,528,140,110,1805,1062,59,125,250
34013008100,0.9379342288096341,0.06206577119036591,2118,0,407,1111,435,"Census Tract 81, Essex County, New Jersey",0,223,144,1414,201,96,40,53,1972,2025,19,0,188,265,123,3393,2159,134,19,388
34013008200,0.9405469678953626,0.059453032104637336,708,0,426,355,197,"Census Tract 82, Essex County, New Jersey",0,186,40,289,48,130,15,102,689,791,133,0,196,286,7,1685,841,50,133,293
34013008700,0.8418740849194729,0.1581259150805271,1067,0,721,375,131,"Census Tract 87, Essex County, New Jersey",0,154,84,16,40,482,291,546,604,1150,142,297,1546,188,94,1803,1366,216,439,282
34013008800,0.8508771929824561,0.14912280701754385,494,0,324,172,298,"Census Tract 88, Essex County, New Jersey",0,96,43,0,44,200,111,135,447,582,0,68,525,212,44,1361,684,102,68,256
34013008900,0.8140643623361145,0.18593563766388557,682,0,185,335,218,"Census Tract 89, Essex County, New Jersey",0,23,32,13,34,335,245,162,521,683,105,44,433,13,23,1400,839,156,149,36
34013009000,0.9566630552546046,0.04333694474539545,817,0,363,395,437,"Census Tract 90, Essex County, New Jersey",0,16,83,566,0,24,128,0,883,883,0,0,0,302,61,1854,923,40,0,363
34013009100,0.8156378600823045,0.18436213991769548,1035,0,322,394,436,"Census Tract 91, Essex County, New Jersey",0,125,0,0,164,466,280,284,707,991,118,75,945,67,62,1902,1215,224,193,129
34013009200,0.8970718722271517,0.10292812777284827,788,0.019520851818988466,503,472,192,"Census Tract 92, Essex County, New Jersey",22,78,109,109,107,204,181,215,796,1011,120,75,711,160,148,1914,1127,116,195,308
34013009300,0.8680149015433741,0.13198509845662587,1569,0,797,504,637,"Census Tract 93, Essex County, New Jersey",0,138,330,103,131,499,368,352,1279,1631,62,411,1447,132,192,3722,1879,248,473,324
34013009400,0.9553816046966732,0.04461839530332681,1980,0,1553,666,1009,"Census Tract 94, Essex County, New Jersey",0,175,515,525,36,559,170,674,1767,2441,669,491,2305,276,117,3652,2555,114,1160,393
34013009500,0.9288601455133387,0.07113985448666128,2074,0,991,893,1023,"Census Tract 95, Essex County, New Jersey",0,154,44,908,121,486,361,510,1788,2298,357,234,1538,213,187,4052,2474,176,591,400
34013009600,0.9631760644418872,0.03682393555811277,1441,0,526,507,779,"Census Tract 96, Essex County, New Jersey",0,76,101,30,131,613,490,308,1366,1674,127,208,792,32,159,4082,1738,64,335,191
34013009700,0.9123975409836066,0.08760245901639344,1779,0,809,528,475,"Census Tract 97, Essex County, New Jersey",0,217,252,57,278,516,459,432,1349,1781,376,201,1330,212,20,4030,1952,171,577,232
34013009900,0.8967136150234741,0.10328638497652583,779,0,671,246,257,"Census Tract 99, Essex County, New Jersey",0,33,30,287,92,190,147,274,681,955,393,185,1005,27,66,1454,1065,110,578,93
34013010000,0.8476499189627229,0.15235008103727715,698,0,861,182,352,"Census Tract 100, Essex County, New Jersey",0,67,142,85,68,179,157,487,559,1046,297,548,1946,0,16,970,1234,188,845,16
34013010100,0.8890977443609023,0.11090225563909774,644,0,737,191,229,"Census Tract 101, Essex County, New Jersey",0,91,34,48,58,197,216,424,522,946,305,196,1426,194,42,1319,1064,118,501,236
34013010200,0.8724100327153762,0.12758996728462377,1154,0,1321,494,368,"Census Tract 102, Essex County, New Jersey",0,58,19,449,0,245,383,614,986,1600,183,757,1997,357,24,2359,1834,234,940,381
34013010300,0.8012461059190031,0.1987538940809969,1333,0,426,404,343,"Census Tract 103, Essex County, New Jersey",0,131,118,255,78,493,258,484,802,1286,49,275,1438,69,33,1800,1605,319,324,102
34013010400,0.90239651416122,0.09760348583877995,2114,0,903,609,759,"Census Tract 104, Essex County, New Jersey",0,273,221,666,438,385,131,385,1686,2071,123,313,1152,299,168,3407,2295,224,436,467
34013010500,0.9166666666666666,0.08333333333333333,1668,0,693,673,596,"Census Tract 105, Essex County, New Jersey",0,113,368,660,77,346,104,324,1535,1859,236,137,1148,279,41,3660,2028,169,373,320
34013010600,0.7750791974656811,0.2249208025343189,1783,0,258,747,712,"Census Tract 106, Essex County, New Jersey",0,299,713,403,79,178,111,96,1372,1468,5,18,319,129,106,3649,1894,426,23,235
34013010700,0.6900763358778625,0.3099236641221374,899,0,503,261,350,"Census Tract 107, Essex County, New Jersey",0,75,188,123,59,226,228,253,651,904,91,245,1052,80,87,1799,1310,406,336,167
34013010800,0.6917670682730924,0.30823293172690763,779,0,613,233,333,"Census Tract 108, Essex County, New Jersey",0,25,31,0,20,354,349,300,389,689,138,267,1175,87,121,1423,996,307,405,208
34013010900,0.6655490360435876,0.3344509639564124,794,0,789,194,99,"Census Tract 109, Essex County, New Jersey",0,32,143,143,20,156,300,260,534,794,317,372,1019,83,17,1552,1193,399,689,100
34013011100,0.8996487706974411,0.10035122930255895,1971,0,556,806,522,"Census Tract 111, Essex County, New Jersey",0,66,531,1289,10,52,23,41,1752,1793,0,0,41,433,123,3945,1993,200,0,556
34013011200,0.9036476256022024,0.09635237439779766,1269,0,592,617,346,"Census Tract 112, Essex County, New Jersey",0,238,274,231,94,218,214,204,1109,1313,212,108,682,167,105,2703,1453,140,320,272
34013011300,0.865015479876161,0.13498452012383902,1595,0,238,455,618,"Census Tract 113, Essex County, New Jersey",0,135,595,697,32,50,86,22,1375,1397,5,6,92,119,108,3536,1615,218,11,227
34013011400,0.90673828125,0.09326171875,1637,0,816,319,409,"Census Tract 114, Essex County, New Jersey",0,67,250,793,115,152,260,609,1248,1857,186,392,1502,141,97,2939,2048,191,578,238
34013011500,0.7926008968609866,0.20739910313901344,542,0,588,209,357,"Census Tract 115, Essex County, New Jersey",0,19,0,0,41,159,323,330,377,707,232,301,1211,6,49,1137,892,185,533,55
34013011600,0.8019713261648745,0.19802867383512546,927,0,305,295,330,"Census Tract 116, Essex County, New Jersey",0,89,60,11,83,435,249,155,740,895,110,149,749,0,46,2585,1116,221,259,46
34013011700,0.8197481776010603,0.1802518223989397,1047,0,846,277,242,"Census Tract 117, Essex County, New Jersey",0,62,125,302,67,352,139,388,849,1237,232,484,1209,24,106,1728,1509,272,716,130
34013011800,0.8231009365244537,0.1768990634755463,645,0,737,151,124,"Census Tract 118, Essex County, New Jersey",0,5,7,0,43,243,347,460,331,791,275,354,1421,74,34,756,961,170,629,108
34013011900,0.9047619047619048,0.09523809523809523,835,0,224,235,209,"Census Tract 119, Essex County, New Jersey",0,218,328,26,103,71,89,69,748,817,51,44,240,81,48,1361,903,86,95,129
34013012000,0.905320813771518,0.09467918622848201,1947,0.018388106416275432,774,391,311,"Census Tract 120, Essex County, New Jersey",47,356,471,57,121,543,399,597,1717,2314,58,321,2015,49,346,4166,2556,242,379,395
34013012100,0.7886435331230284,0.2113564668769716,1358,0,766,391,627,"Census Tract 121, Essex County, New Jersey",0,155,170,89,36,440,468,277,973,1250,370,189,768,190,17,2989,1585,335,559,207
34013012200,0.8887423043095867,0.11125769569041337,1830,0,1014,494,535,"Census Tract 122, Essex County, New Jersey",0,55,43,58,123,1062,489,471,1550,2021,401,357,1492,227,29,3630,2274,253,758,256
34013012300,0.8649164677804296,0.1350835322195704,1496,0,1196,211,541,"Census Tract 123, Essex County, New Jersey",0,230,113,105,234,344,470,720,1092,1812,210,799,2012,120,67,3057,2095,283,1009,187
34013012400,0.8968481375358166,0.10315186246418338,1720,0,845,813,348,"Census Tract 124, Essex County, New Jersey",0,59,133,779,98,393,258,417,1461,1878,278,313,1669,182,72,2812,2094,216,591,254
34013012500,0.7486725663716814,0.2513274336283186,1219,0.01592920353982301,1143,369,437,"Census Tract 125, Essex County, New Jersey",27,19,175,172,29,433,391,602,667,1269,457,560,1990,114,12,1585,1695,426,1017,126
34013012600,0.7516339869281046,0.24836601307189543,1140,0,924,193,254,"Census Tract 126, Essex County, New Jersey",0,25,97,0,84,607,327,338,697,1035,257,284,947,75,308,1966,1377,342,541,383
34013012700,0.8427787934186471,0.15722120658135283,1077,0,1242,275,235,"Census Tract 127, Essex County, New Jersey",0,52,153,0,187,180,505,569,814,1383,208,762,1927,256,16,2275,1641,258,970,272
34013012800,0.7998760842627014,0.20012391573729862,1392,0,742,315,338,"Census Tract 128, Essex County, New Jersey",0,88,154,50,78,405,617,408,883,1291,265,312,1407,165,0,1947,1614,323,577,165
34013012900,0.8697705802968961,0.13022941970310392,1259,0,490,456,495,"Census Tract 129, Essex County, New Jersey",0,61,78,131,139,488,362,275,1014,1289,62,277,846,106,45,2642,1482,193,339,151
34013013000,0.9514331210191083,0.04856687898089172,1256,0,188,429,430,"Census Tract 130, Essex County, New Jersey",0,55,26,1139,11,0,25,0,1195,1195,0,0,0,80,108,1935,1256,61,0,188
34013013100,0.6945412311265969,0.305458768873403,737,0,286,219,207,"Census Tract 131, Essex County, New Jersey",0,10,66,16,85,423,137,173,425,598,27,259,538,0,0,1479,861,263,286,0
34013013200,0.7416787264833574,0.2583212735166425,1281,0,535,485,243,"Census Tract 132, Essex County, New Jersey",0,125,14,18,125,386,613,390,635,1025,196,243,1083,11,85,1260,1382,357,439,96
34013013300,0.6868347338935574,0.3131652661064426,1665,0,1087,464,437,"Census Tract 133, Essex County, New Jersey",0,69,136,100,210,562,588,282,944,1226,126,318,1037,359,284,2538,1785,559,444,643
34013013400,1,0,152,0,1968,45,308,"Census Tract 134, Essex County, New Jersey",0,0,68,8,0,58,18,1223,218,1441,841,1079,3489,48,0,360,1441,0,1920,48
34013013500,0.9836264402668283,0.01637355973317162,466,0,1129,91,393,"Census Tract 135, Essex County, New Jersey",0,8,95,15,227,99,22,1194,428,1622,619,491,3554,0,19,859,1649,27,1110,19
34013013600,0.9052904180540141,0.09470958194598594,1221,0,1563,117,698,"Census Tract 136, Essex County, New Jersey",0,233,244,138,118,122,366,1454,993,2447,781,594,4652,106,82,2005,2703,256,1375,188
34013013700,0.9626937984496124,0.037306201550387594,1523,0.001937984496124031,1394,430,487,"Census Tract 137, Essex County, New Jersey",4,98,240,336,109,152,588,824,1163,1987,332,704,2177,165,193,2156,2064,77,1036,358
34013013800,0.9799025578562729,0.020097442143727162,368,0,1640,118,261,"Census Tract 138, Essex County, New Jersey",0,118,81,49,56,44,20,1240,369,1609,586,918,3596,19,117,657,1642,33,1504,136
34013013900,0.9345142243692969,0.06548577563070317,554,0,1594,79,235,"Census Tract 139, Essex County, New Jersey",0,70,48,55,31,76,274,1237,504,1741,584,898,3939,68,44,995,1863,122,1482,112
34013014000,0.9400630914826499,0.05993690851735016,618,0,1178,24,209,"Census Tract 140, Essex County, New Jersey",0,107,33,110,16,247,105,1101,389,1490,648,465,3184,65,0,828,1585,95,1113,65
34013014100,0.9931818181818182,0.006818181818181818,529,0,1447,45,167,"Census Tract 141, Essex County, New Jersey",0,67,31,16,0,79,336,902,409,1311,750,574,2559,117,6,1142,1320,9,1324,123
34013014200,0.9579405366207396,0.04205946337926034,443,0,1116,86,270,"Census Tract 142, Essex County, New Jersey",0,27,78,0,54,10,274,906,415,1321,526,430,2881,160,0,1215,1379,58,956,160
34013014300,0.8670756646216768,0.1329243353783231,1088,0,1753,128,250,"Census Tract 143, Essex County, New Jersey",0,37,79,0,97,356,519,998,698,1696,929,529,3130,106,189,2324,1956,260,1458,295
34013014400,0.8739913097454997,0.12600869025450032,1174,0,976,104,136,"Census Tract 144, Essex County, New Jersey",0,306,205,32,178,107,346,487,921,1408,312,361,1293,214,89,2403,1611,203,673,303
34013014500,0.9025341130604289,0.09746588693957114,1231,0,1197,114,279,"Census Tract 145, Essex County, New Jersey",0,181,77,32,186,181,574,582,807,1389,890,250,2162,47,10,2431,1539,150,1140,57
34013014600,0.9180622009569378,0.0819377990430622,870,0,795,30,177,"Census Tract 146, Essex County, New Jersey",0,61,32,78,86,187,426,807,728,1535,361,386,2523,0,48,2002,1672,137,747,48
34013014700,0.9021056520132988,0.09789434798670114,2246,0,961,315,359,"Census Tract 147, Essex County, New Jersey",0,386,267,153,474,301,665,623,1819,2442,241,308,1632,337,75,4341,2707,265,549,412
34013014800,0.9817073170731707,0.018292682926829267,73,0,1259,47,206,"Census Tract 148, Essex County, New Jersey",0,6,15,0,8,0,44,1030,97,1127,815,436,3024,8,0,211,1148,21,1251,8
34013014900,1,0,12,0,1675,41,412,"Census Tract 149, Essex County, New Jersey",0,0,0,0,0,12,0,1454,85,1539,777,889,4526,0,9,236,1539,0,1666,9
34013015000,0.9625090122566691,0.03749098774333093,545,0,876,38,345,"Census Tract 150, Essex County, New Jersey",0,61,35,30,71,327,21,834,501,1335,259,592,2117,25,0,1007,1387,52,851,25
34013015100,0.9681493684788578,0.03185063152114223,784,0,1545,58,206,"Census Tract 151, Essex County, New Jersey",0,34,31,91,0,132,496,1106,657,1763,755,655,3588,120,15,1305,1821,58,1410,135
34013015200,0.948905109489051,0.051094890510948905,1146,0,839,208,299,"Census Tract 152, Essex County, New Jersey",0,112,17,149,153,263,452,753,807,1560,197,466,2139,79,97,1953,1644,84,663,176
34013015300,0.9400958466453674,0.05990415335463259,976,0,368,62,254,"Census Tract 153, Essex County, New Jersey",0,149,6,9,64,562,186,303,874,1177,153,122,817,58,35,1896,1252,75,275,93
34013015400,0.9548775247099269,0.04512247529007306,1900,0,726,179,288,"Census Tract 154, Essex County, New Jersey",0,277,569,364,139,294,257,427,1795,2222,110,204,1054,235,177,3447,2327,105,314,412
34013015500,0.9369806094182825,0.06301939058171745,609,0,1025,29,277,"Census Tract 155, Essex County, New Jersey",0,68,11,15,55,147,313,933,420,1353,444,503,3077,57,21,1128,1444,91,947,78
34013015600,0.932882665379044,0.06711733462095607,1442,0,813,199,716,"Census Tract 156, Essex County, New Jersey",0,97,195,513,90,116,431,821,1111,1932,270,410,2565,52,81,2006,2071,139,680,133
34013015700,0.8456014362657092,0.15439856373429084,899,0,408,154,357,"Census Tract 157, Essex County, New Jersey",0,68,90,217,56,229,239,288,654,942,281,70,959,44,13,1549,1114,172,351,57
34013015800,0.9829059829059829,0.017094017094017096,1073,0,1164,281,375,"Census Tract 158, Essex County, New Jersey",0,137,271,131,10,209,315,576,919,1495,493,322,1862,106,243,2357,1521,26,815,349
34013015900,0.9268707482993197,0.07312925170068027,1034,0,992,301,586,"Census Tract 159, Essex County, New Jersey",0,27,61,0,55,398,493,866,769,1635,330,513,2966,142,7,2401,1764,129,843,149
34013016000,0.9684252597921663,0.03157474020783373,308,0,2470,27,1258,"Census Tract 160, Essex County, New Jersey",0,5,16,162,0,71,54,2284,139,2423,1620,840,7180,10,0,358,2502,79,2460,10
34013016100,0.9697239536954586,0.030276046304541407,189,0,1249,32,565,"Census Tract 161, Essex County, New Jersey",0,8,22,0,19,56,84,872,217,1089,686,541,2827,22,0,584,1123,34,1227,22
34013016200,0.9651871192341166,0.034812880765883375,27,0,1039,6,507,"Census Tract 162, Essex County, New Jersey",0,0,0,0,0,11,16,1055,54,1109,514,491,3214,34,0,131,1149,40,1005,34
34013016300,0.9657738095238095,0.03422619047619048,449,0,1038,78,441,"Census Tract 163, Essex County, New Jersey",0,30,83,129,70,19,118,953,345,1298,656,323,3009,48,11,692,1344,46,979,59
34013016400,0.9766593727206418,0.023340627279358133,602,0,800,57,473,"Census Tract 164, Essex County, New Jersey",0,32,92,46,62,291,79,959,380,1339,459,329,2655,0,12,870,1371,32,788,12
34013016500,0.9323308270676691,0.06766917293233082,424,0,1170,89,622,"Census Tract 165, Essex County, New Jersey",0,0,0,75,25,140,184,1072,292,1364,588,541,3270,34,7,567,1463,99,1129,41
34013016600,0.9402214022140222,0.05977859778597786,1026,0,736,139,453,"Census Tract 166, Essex County, New Jersey",0,29,41,79,116,326,435,443,831,1274,241,437,1347,31,27,1816,1355,81,678,58
34013016700,0.8945086705202312,0.10549132947976879,1250,0,547,249,464,"Census Tract 167, Essex County, New Jersey",0,81,217,245,317,137,253,290,948,1238,213,151,892,97,86,1698,1384,146,364,183
34013016800,0.8835106382978724,0.11648936170212766,1598,0,498,351,384,"Census Tract 168, Essex County, New Jersey",0,287,400,327,176,192,216,527,1134,1661,156,191,1217,66,85,2173,1880,219,347,151
34013016900,1,0,342,0,806,49,413,"Census Tract 169, Essex County, New Jersey",0,53,71,0,95,11,112,756,328,1084,433,362,2185,0,11,685,1084,0,795,11
34013017000,0.9363057324840764,0.06369426751592357,871,0,623,70,444,"Census Tract 170, Essex County, New Jersey",0,222,192,73,124,175,85,544,632,1176,521,82,1571,11,9,918,1256,80,603,20
34013017100,0.9303135888501742,0.06968641114982578,658,0,423,214,157,"Census Tract 171, Essex County, New Jersey",0,12,31,0,118,185,312,272,529,801,179,167,842,34,43,1581,861,60,346,77
34013017200,0.9079754601226994,0.09202453987730061,330,0,865,124,391,"Census Tract 172, Essex County, New Jersey",0,0,0,25,19,79,207,718,318,1036,572,293,2341,0,0,827,1141,105,865,0
34013017301,0.9250916710319539,0.0749083289680461,149,0,1566,104,328,"Census Tract 173.01, Essex County, New Jersey",0,0,7,118,0,8,16,1664,102,1766,977,542,5008,47,0,212,1909,143,1519,47
34013017302,0.948236069897791,0.05176393010220903,1184,0,1963,164,413,"Census Tract 173.02, Essex County, New Jersey",0,166,68,351,142,228,229,1837,1039,2876,928,921,4749,78,36,2306,3033,157,1849,114
34013017400,0.9581898671913428,0.041810132808657155,316,0,2018,88,311,"Census Tract 174, Essex County, New Jersey",0,0,0,112,37,87,80,1564,384,1948,1279,693,4683,12,34,813,2033,85,1972,46
34013017500,0.946685878962536,0.053314121037463975,1035,0,1419,249,451,"Census Tract 175, Essex County, New Jersey",0,127,44,402,125,178,159,1614,1014,2628,472,760,4379,120,67,1802,2776,148,1232,187
34013017600,0.9281159420289855,0.07188405797101449,1077,0,1122,163,314,"Census Tract 176, Essex County, New Jersey",0,18,31,198,13,288,529,822,779,1601,553,228,2871,239,102,2091,1725,124,781,341
34013017700,0.8618714194780395,0.13812858052196053,1047,0,1041,300,412,"Census Tract 177, Essex County, New Jersey",0,64,81,0,95,312,495,504,850,1354,502,172,1804,269,98,3110,1571,217,674,367
34013017800,0.8203252032520325,0.1796747967479675,846,0,409,187,328,"Census Tract 178, Essex County, New Jersey",0,0,35,202,6,177,426,339,670,1009,202,111,1255,59,37,1882,1230,221,313,96
34013017900,0.9808695652173913,0.019130434782608695,58,0,1620,19,511,"Census Tract 179, Essex County, New Jersey",0,0,0,0,0,17,41,1077,51,1128,839,781,3345,0,0,232,1150,22,1620,0
34013018000,0.9595910418695229,0.04040895813047712,153,0,2441,48,732,"Census Tract 180, Essex County, New Jersey",0,52,26,50,0,0,25,1692,279,1971,1679,688,5030,0,74,650,2054,83,2367,74
34013018100,0.9263038548752834,0.07369614512471655,541,0.011337868480725623,640,194,207,"Census Tract 181, Essex County, New Jersey",10,23,7,39,0,311,161,262,555,817,168,240,713,137,95,1408,882,65,408,232
34013018200,0.9123738714816781,0.08762612851832183,1516,0,1125,690,278,"Census Tract 182, Essex County, New Jersey",0,121,333,476,203,172,211,214,1504,1718,232,311,935,390,192,3235,1883,165,543,582
34013018300,0.9325498211548289,0.06745017884517118,1686,0,346,640,925,"Census Tract 183, Essex County, New Jersey",0,159,430,252,114,314,417,153,1672,1825,168,23,487,94,61,4425,1957,132,191,155
34013018400,0.8086710650329878,0.19132893496701225,824,0,347,370,264,"Census Tract 184, Essex County, New Jersey",0,73,179,157,72,127,216,205,653,858,75,206,668,42,24,1406,1061,203,281,66
34013018600,0.9334195216548158,0.06658047834518423,1266,0,308,659,668,"Census Tract 186, Essex County, New Jersey",0,67,105,63,259,441,331,159,1285,1444,235,73,509,0,0,3385,1547,103,308,0
34013018700,0.9557383470426949,0.04426165295730513,2196,0,1066,810,485,"Census Tract 187, Essex County, New Jersey",0,232,328,1094,108,179,255,454,1986,2440,101,256,1037,611,98,3716,2553,113,357,709
34013018800,0.927536231884058,0.07246376811594203,1033,0,1426,265,404,"Census Tract 188, Essex County, New Jersey",0,103,386,184,110,96,154,852,940,1792,452,655,2279,287,32,1959,1932,140,1107,319
34013018900,0.8911949685534591,0.10880503144654088,1072,0,688,396,390,"Census Tract 189, Essex County, New Jersey",0,45,232,129,133,142,391,325,1092,1417,346,264,771,28,50,3088,1590,173,610,78
34013019000,0.9498371335504886,0.0501628664495114,87,0,1152,19,757,"Census Tract 190, Essex County, New Jersey",0,0,0,87,0,0,0,1438,20,1458,637,515,4178,0,0,89,1535,77,1152,0
34013019100,0.9071597167584579,0.09284028324154209,116,0,1546,44,591,"Census Tract 191, Essex County, New Jersey",0,0,14,53,0,0,49,1052,101,1153,1082,464,3636,0,0,284,1271,118,1546,0
34013019200,0.9183673469387755,0.08163265306122448,568,0,659,187,306,"Census Tract 192, Essex County, New Jersey",0,135,118,121,38,24,132,548,487,1035,219,317,1570,114,9,1219,1127,92,536,123
34013019300,0.8993975903614457,0.10060240963855421,1199,0,606,293,635,"Census Tract 193, Essex County, New Jersey",0,238,168,479,48,92,174,517,976,1493,393,168,1579,45,0,1911,1660,167,561,45
34013019400,0.9813084112149533,0.018691588785046728,124,0,765,34,633,"Census Tract 194, Essex County, New Jersey",0,0,7,99,0,0,18,920,25,945,534,231,2886,0,0,126,963,18,765,0
34013019500,0.9764437689969605,0.023556231003039513,156,0,1079,8,835,"Census Tract 195, Essex County, New Jersey",0,0,30,78,0,27,21,1208,77,1285,662,409,3679,0,8,192,1316,31,1071,8
34013019600,0.8979322481302243,0.10206775186977562,897,0,1946,347,772,"Census Tract 196, Essex County, New Jersey",0,26,24,150,16,232,449,1412,629,2041,976,864,4211,80,26,1667,2273,232,1840,106
34013019700,0.8714350384789498,0.12856496152105024,1207,0,1638,152,454,"Census Tract 197, Essex County, New Jersey",0,46,81,80,35,181,784,1096,829,1925,1195,331,3815,112,0,2528,2209,284,1526,112
34013019800,1,0,84,0,832,57,404,"Census Tract 198, Essex County, New Jersey",0,6,0,26,6,18,28,767,146,913,420,360,2429,52,0,403,913,0,780,52
34013019900,0.988998899889989,0.011001100110011002,201,0,626,27,495,"Census Tract 199, Essex County, New Jersey",0,24,9,90,0,69,9,715,184,899,329,286,2285,11,0,302,909,10,615,11
34013020000,0.9759910664433278,0.02400893355667225,10,0,1391,10,708,"Census Tract 200, Essex County, New Jersey",0,0,10,0,0,0,0,1686,62,1748,1021,341,5669,0,29,187,1791,43,1362,29
34013020100,0.9915912031047865,0.008408796895213453,17,0,1513,0,531,"Census Tract 201, Essex County, New Jersey",0,0,0,9,0,0,8,1411,122,1533,1064,419,4563,0,30,339,1546,13,1483,30
34013020200,0.9565982404692082,0.04340175953079179,232,0,1701,27,751,"Census Tract 202, Essex County, New Jersey",0,40,45,7,44,73,23,1318,313,1631,1117,584,3942,0,0,978,1705,74,1701,0
34013020300,0.8894230769230769,0.11057692307692307,966,0.004273504273504274,1034,108,666,"Census Tract 203, Essex County, New Jersey",8,40,169,51,87,176,443,914,751,1665,505,476,2587,45,8,1885,1872,207,981,53
34013020400,0.9893446989877464,0.010655301012253596,252,0,1973,81,352,"Census Tract 204, Essex County, New Jersey",0,0,137,91,11,0,13,1678,179,1857,1086,887,4893,0,0,443,1877,20,1973,0
34013020500,0.9403268719118206,0.0596731280881794,74,0,3432,0,512,"Census Tract 205, Essex County, New Jersey",0,53,0,0,21,0,0,2414,60,2474,1824,1587,7400,21,0,253,2631,157,3411,21
34013020600,0.9353778751369113,0.06462212486308871,249,0,1500,142,334,"Census Tract 206, Essex County, New Jersey",0,25,69,105,7,28,15,1376,332,1708,575,843,4334,51,31,518,1826,118,1418,82
34013020700,0.9254823685961411,0.07451763140385895,24,0,1938,71,270,"Census Tract 207, Essex County, New Jersey",0,0,0,11,13,0,0,1294,97,1391,952,938,3935,0,48,301,1503,112,1890,48
34013020800,0.9827520122652357,0.017247987734764277,294,0,2370,110,336,"Census Tract 208, Essex County, New Jersey",0,42,74,79,60,11,28,2105,459,2564,1047,1323,6278,0,0,999,2609,45,2370,0
34013020901,0.9261430246189918,0.0738569753810082,15,0,781,8,144,"Census Tract 209.01, Essex County, New Jersey",0,2,0,0,0,8,5,749,41,790,530,251,2097,0,0,108,853,63,781,0
34013020902,0.9397832195905259,0.060216780409474105,447,0,1598,32,230,"Census Tract 209.02, Essex County, New Jersey",0,32,0,115,164,86,50,1891,450,2341,1027,513,4952,42,16,897,2491,150,1540,58
34013021000,0.9797717842323651,0.020228215767634856,617,0,1921,43,127,"Census Tract 210, Essex County, New Jersey",0,16,37,232,0,55,277,1354,535,1889,979,942,4238,0,0,938,1928,39,1921,0
34013021100,0.8863858961802155,0.11361410381978453,796,0,2053,84,243,"Census Tract 211, Essex County, New Jersey",0,0,59,600,13,44,80,1583,227,1810,802,1207,3977,29,15,515,2042,232,2009,44
34013021200,0.954014598540146,0.04598540145985401,483,0,1659,24,203,"Census Tract 212, Essex County, New Jersey",0,82,120,45,54,85,97,1060,247,1307,855,796,3278,8,0,443,1370,63,1651,8
34013021300,0.9639459188783175,0.03605408112168253,365,0,2269,71,240,"Census Tract 213, Essex County, New Jersey",0,183,50,18,54,0,60,1705,220,1925,997,1253,5126,0,19,446,1997,72,2250,19
34013021400,0.978690430065866,0.021309569934134055,801,0,2362,190,395,"Census Tract 214, Essex County, New Jersey",0,14,13,233,69,202,270,1837,689,2526,1067,1155,5216,110,30,923,2581,55,2222,140
34013021601,0.9217687074829932,0.0782312925170068,184,0,3059,144,128,"Census Tract 216.01, Essex County, New Jersey",0,31,43,41,25,44,0,2421,289,2710,1649,1410,6900,0,0,500,2940,230,3059,0
34013021602,0.9933361099541858,0.006663890045814244,16,0,2959,39,331,"Census Tract 216.02, Essex County, New Jersey",0,16,0,0,0,0,0,2377,8,2385,1955,1004,6605,0,0,16,2401,16,2959,0
34013021701,0.9532650448143406,0.04673495518565941,907,0,1019,59,135,"Census Tract 217.01, Essex County, New Jersey",0,77,159,303,51,154,163,767,722,1489,567,413,2360,39,0,1256,1562,73,980,39
34013021702,0.8941351888667992,0.1058648111332008,1313,0,777,89,123,"Census Tract 217.02, Essex County, New Jersey",0,251,213,292,182,142,233,801,998,1799,434,279,2121,55,9,1704,2012,213,713,64
34013021801,0.9955156950672646,0.004484304932735426,4,0,1286,23,123,"Census Tract 218.01, Essex County, New Jersey",0,0,0,0,0,0,4,880,8,888,715,571,2688,0,0,33,892,4,1286,0
34013021802,1,0,378,0,1225,211,81,"Census Tract 218.02, Essex County, New Jersey",0,0,123,159,43,18,35,1081,342,1423,535,644,2773,29,17,497,1423,0,1179,46
34013021803,0.9318578916715201,0.0681421083284799,219,0,1868,74,58,"Census Tract 218.03, Essex County, New Jersey",0,39,45,24,0,70,41,1402,198,1600,1107,692,4136,51,18,477,1717,117,1799,69
34013022700,0.8897526501766785,0.11024734982332156,1127,0,582,689,287,"Census Tract 227, Essex County, New Jersey",0,90,88,303,204,210,232,160,1099,1259,38,258,533,148,138,2167,1415,156,296,286
34013022800,0.8726738491674828,0.12732615083251714,678,0,379,483,333,"Census Tract 228, Essex County, New Jersey",0,128,61,246,153,40,50,35,856,891,0,0,135,351,28,2052,1021,130,0,379
34013022900,0.9283667621776505,0.07163323782234957,1000,0,156,721,859,"Census Tract 229, Essex County, New Jersey",0,11,83,624,49,167,66,31,1265,1296,0,66,66,32,58,2524,1396,100,66,90
34013023000,0.8229407236335643,0.17705927636643573,941,0,286,713,248,"Census Tract 230, Essex County, New Jersey",0,94,37,419,97,184,110,53,1016,1069,186,0,258,61,39,2327,1299,230,186,100
34013023100,0.7997936016511867,0.2002063983488132,618,0,521,210,158,"Census Tract 231, Essex County, New Jersey",0,0,44,13,40,260,261,258,517,775,245,103,1007,120,53,1487,969,194,348,173
34013023200,0.7689477557027226,0.23105224429727741,1084,0,573,354,335,"Census Tract 232, Essex County, New Jersey",0,149,210,136,82,279,228,213,832,1045,99,298,797,149,27,2181,1359,314,397,176
34013980100,NaN,NaN,0,NaN,0,0,0,"Census Tract 9801, Essex County, New Jersey",0,0,0,0,0,0,0,0,0,0,0,0,0,0,0,0,0,0,0,0
34013980200,NaN,NaN,0,NaN,0,0,0,"Census Tract 9802, Essex County, New Jersey",0,0,0,0,0,0,0,0,0,0,0,0,0,0,0,0,0,0,0,0
34015500100,0.9124372559955382,0.08756274400446179,617,0,1273,203,151,"Census Tract 5001, Gloucester County, New Jersey",0,74,12,9,112,50,360,1012,624,1636,254,921,2950,44,54,1215,1793,157,1175,98
34015500201,0.9052083333333333,0.09479166666666666,11,0.17395833333333333,1177,75,25,"Census Tract 5002.01, Gloucester County, New Jersey",167,0,0,0,0,3,8,719,150,869,361,751,2002,51,14,425,960,91,1112,65
34015500202,0.9121361889071938,0.08786381109280615,407,0.008786381109280615,2312,91,12,"Census Tract 5002.02, Gloucester County, New Jersey",16,71,98,34,13,60,131,1234,427,1661,928,1319,3569,55,10,760,1821,160,2247,65
34015500203,0.9367023991832568,0.06329760081674324,642,0,1584,94,52,"Census Tract 5002.03, Gloucester County, New Jersey",0,245,21,52,248,67,9,1328,507,1835,741,822,3450,21,0,912,1959,124,1563,21
34015500204,0.9355794150314698,0.06442058496853018,1120,0,1621,126,41,"Census Tract 5002.04, Gloucester County, New Jersey",0,393,160,142,161,204,60,1517,1010,2527,807,726,4640,62,26,1798,2701,174,1533,88
34015500205,0.9290519877675841,0.0709480122324159,316,0.11926605504587157,1020,14,23,"Census Tract 5002.05, Gloucester County, New Jersey",195,8,8,188,40,41,31,1140,379,1519,586,434,2660,0,0,894,1635,116,1020,0
34015500300,0.9247985675917636,0.07520143240823635,105,0,1161,26,15,"Census Tract 5003, Gloucester County, New Jersey",0,0,4,0,5,36,60,855,178,1033,442,708,2502,11,0,458,1117,84,1150,11
34015500400,0.8135160981829773,0.18648390181702262,918,0,2359,440,118,"Census Tract 5004, Gloucester County, New Jersey",0,189,0,57,240,116,316,1687,865,2552,595,1694,4231,70,0,1695,3137,585,2289,70
34015500500,0.9174224343675418,0.08257756563245823,309,0,2135,146,36,"Census Tract 5005, Gloucester County, New Jersey",0,9,7,51,23,55,164,1557,365,1922,877,1229,4143,9,20,681,2095,173,2106,29
34015500600,0.9448295782784517,0.055170421721548235,66,0,1844,112,45,"Census Tract 5006, Gloucester County, New Jersey",0,0,0,0,0,25,41,3063,208,3271,753,1063,9629,0,28,623,3462,191,1816,28
34015500701,0.945662241432541,0.054337758567459093,437,0.08027168879283729,2524,150,102,"Census Tract 5007.01, Gloucester County, New Jersey",260,15,19,0,278,65,60,2709,354,3063,1797,673,6891,54,0,884,3239,176,2470,54
34015500702,0.9561113732892874,0.0438886267107126,30,0,2634,55,36,"Census Tract 5007.02, Gloucester County, New Jersey",0,0,0,0,30,0,0,1886,140,2026,1635,930,5480,0,69,411,2119,93,2565,69
34015500703,0.9362101313320825,0.06378986866791744,61,0,692,5,8,"Census Tract 5007.03, Gloucester County, New Jersey",0,0,0,0,0,0,61,427,72,499,378,298,1184,16,0,110,533,34,676,16
34015500800,0.9239130434782609,0.07608695652173914,27,0,984,24,20,"Census Tract 5008, Gloucester County, New Jersey",0,0,0,0,5,13,9,725,40,765,515,446,2111,16,7,105,828,63,961,23
34015500900,0.9733333333333334,0.02666666666666667,75,0,1179,32,43,"Census Tract 5009, Gloucester County, New Jersey",0,0,9,0,15,5,46,988,107,1095,343,804,2766,32,0,219,1125,30,1147,32
34015501001,0.8560090702947846,0.14399092970521543,117,0,640,43,4,"Census Tract 5010.01, Gloucester County, New Jersey",0,12,0,17,32,4,52,546,209,755,237,371,1487,0,32,601,882,127,608,32
34015501002,0.8573493975903614,0.14265060240963856,1136,0,763,579,82,"Census Tract 5010.02, Gloucester County, New Jersey",0,89,94,435,101,275,142,629,1150,1779,220,321,1669,196,26,2632,2075,296,541,222
34015501003,0.8637223974763407,0.1362776025236593,266,0,1023,206,87,"Census Tract 5010.03, Gloucester County, New Jersey",0,11,0,0,99,73,83,994,375,1369,597,405,2330,21,0,1118,1585,216,1002,21
34015501101,0.9336708860759494,0.06632911392405064,818,0,1651,276,23,"Census Tract 5011.01, Gloucester County, New Jersey",0,438,84,214,62,20,0,1103,741,1844,866,708,2796,42,35,1106,1975,131,1574,77
34015501102,0.9273322422258592,0.07266775777414075,771,0,1520,187,84,"Census Tract 5011.02, Gloucester County, New Jersey",0,276,32,19,161,246,37,2025,808,2833,1164,316,5247,27,13,1601,3055,222,1480,40
34015501103,0.9230769230769231,0.07692307692307693,20,0,2078,16,54,"Census Tract 5011.03, Gloucester County, New Jersey",0,0,0,0,0,0,20,1585,143,1728,1174,898,4798,6,0,349,1872,144,2072,6
34015501104,0.9475555555555556,0.052444444444444446,138,0.024888888888888887,1193,72,61,"Census Tract 5011.04, Gloucester County, New Jersey",28,20,56,0,42,10,10,873,193,1066,275,889,2453,29,0,498,1125,59,1164,29
34015501105,0.9606953892668179,0.039304610733182165,630,0,708,83,40,"Census Tract 5011.05, Gloucester County, New Jersey",0,127,64,56,294,78,11,609,662,1271,307,384,1696,8,9,1293,1323,52,691,17
34015501106,0.9487179487179487,0.05128205128205128,100,0,1398,61,20,"Census Tract 5011.06, Gloucester County, New Jersey",0,76,8,0,16,0,0,1205,201,1406,812,577,3244,9,0,523,1482,76,1389,9
34015501107,0.9829652996845426,0.017034700315457414,71,0,2059,61,54,"Census Tract 5011.07, Gloucester County, New Jersey",0,10,0,0,33,10,18,1370,188,1558,470,1562,3917,27,0,477,1585,27,2032,27
34015501201,0.9587525150905433,0.04124748490945674,0,0,2919,9,58,"Census Tract 5012.01, Gloucester County, New Jersey",0,0,0,0,0,0,0,1849,57,1906,1667,1239,6174,0,13,127,1988,82,2906,13
34015501202,1,0,22,0,2492,0,122,"Census Tract 5012.02, Gloucester County, New Jersey",0,9,0,0,0,13,0,1512,15,1527,1122,1370,4719,0,0,43,1527,0,2492,0
34015501203,0.9221879815100154,0.07781201848998459,215,0,1494,20,101,"Census Tract 5012.03, Gloucester County, New Jersey",0,31,9,0,126,39,10,1107,90,1197,513,939,3017,21,21,166,1298,101,1452,42
34015501204,0.9402214022140222,0.05977859778597786,0,0,1832,19,10,"Census Tract 5012.04, Gloucester County, New Jersey",0,0,0,0,0,0,0,1240,34,1274,925,907,3520,0,0,171,1355,81,1832,0
34015501205,0.9458128078817734,0.054187192118226604,174,0.07192118226600985,1017,89,15,"Census Tract 5012.05, Gloucester County, New Jersey",73,0,17,0,119,5,33,853,107,960,668,349,2421,0,0,325,1015,55,1017,0
34015501206,0.9775208734746307,0.0224791265253693,624,0,1463,279,50,"Census Tract 5012.06, Gloucester County, New Jersey",0,153,46,333,0,61,31,929,593,1522,683,738,2708,31,11,975,1557,35,1421,42
34015501208,0.9366568914956012,0.06334310850439882,376,0,1172,95,30,"Census Tract 5012.08, Gloucester County, New Jersey",0,0,13,26,221,108,8,1399,198,1597,561,611,3594,0,0,416,1705,108,1172,0
34015501209,0.8960526315789473,0.10394736842105264,1363,0,1354,181,99,"Census Tract 5012.09, Gloucester County, New Jersey",0,316,424,158,368,75,22,1662,1062,2724,607,632,4477,115,0,2538,3040,316,1239,115
34015501210,0.9587194608256108,0.041280539174389216,0,0,1772,10,9,"Census Tract 5012.10, Gloucester County, New Jersey",0,0,0,0,0,0,0,1127,11,1138,982,790,3456,0,0,75,1187,49,1772,0
34015501212,0.9362920544022906,0.06370794559770938,189,0,1220,81,132,"Census Tract 5012.12, Gloucester County, New Jersey",0,39,0,0,79,61,10,921,387,1308,390,703,2670,75,52,1085,1397,89,1093,127
34015501213,0.9870931537598204,0.012906846240179574,482,0,1885,153,14,"Census Tract 5012.13, Gloucester County, New Jersey",0,16,0,97,281,79,9,1464,295,1759,1330,547,4302,0,8,611,1782,23,1877,8
34015501301,0.9770773638968482,0.022922636103151862,264,0,1432,56,68,"Census Tract 5013.01, Gloucester County, New Jersey",0,42,18,15,68,61,60,1086,278,1364,478,894,2942,16,44,561,1396,32,1372,60
34015501302,0.8567839195979899,0.14321608040201006,236,0,626,123,0,"Census Tract 5013.02, Gloucester County, New Jersey",0,31,10,0,57,34,104,661,362,1023,405,221,1802,0,0,951,1194,171,626,0
34015501303,0.9436893203883495,0.05631067961165048,200,0,915,102,25,"Census Tract 5013.03, Gloucester County, New Jersey",0,8,24,113,28,0,27,703,269,972,300,547,1993,0,68,476,1030,58,847,68
34015501402,0.7799196787148595,0.22008032128514057,450,0,1048,106,69,"Census Tract 5014.02, Gloucester County, New Jersey",0,0,71,68,11,222,78,502,469,971,286,637,1583,46,79,1517,1245,274,923,125
34015501403,0.8550891316848763,0.14491086831512365,275,0,990,60,35,"Census Tract 5014.03, Gloucester County, New Jersey",0,9,44,0,48,75,99,1237,250,1487,444,546,3194,0,0,630,1739,252,990,0
34015501404,0.8342440801457195,0.1657559198542805,354,0,241,47,0,"Census Tract 5014.04, Gloucester County, New Jersey",0,125,130,41,32,19,7,167,291,458,105,113,476,0,23,692,549,91,218,23
34015501405,0.949535192563081,0.05046480743691899,214,0.0073041168658698535,1635,61,65,"Census Tract 5014.05, Gloucester County, New Jersey",11,41,0,10,78,26,59,1205,225,1430,1255,370,3780,10,0,645,1506,76,1625,10
34015501406,0.8891377379619261,0.11086226203807391,661,0,1189,72,45,"Census Tract 5014.06, Gloucester County, New Jersey",0,282,105,39,151,69,15,956,632,1588,686,472,2804,20,11,1847,1786,198,1158,31
34015501500,0.8911313246162592,0.10886867538374076,493,0,2673,133,109,"Census Tract 5015, Gloucester County, New Jersey",0,43,16,195,82,76,81,2475,660,3135,1739,775,6833,116,43,1699,3518,383,2514,159
34015501603,0.9546742209631728,0.0453257790368272,589,0.00424929178470255,2477,244,77,"Census Tract 5016.03, Gloucester County, New Jersey",12,267,29,38,63,103,89,2042,654,2696,1507,837,4818,73,60,1228,2824,128,2344,133
34015501604,0.8820931022765885,0.11790689772341148,501,0.006455997281685355,1671,295,157,"Census Tract 5016.04, Gloucester County, New Jersey",19,66,63,160,94,0,118,2098,498,2596,618,1034,6359,19,0,912,2943,347,1652,19
34015501605,0.8644251626898047,0.13557483731019523,81,0.2635574837310195,1451,82,31,"Census Tract 5016.05, Gloucester County, New Jersey",486,0,0,26,0,0,55,1447,147,1594,549,873,4038,12,17,357,1844,250,1422,29
34015501606,0.961771385314156,0.038228614685844056,35,0.004542013626040878,2478,39,126,"Census Tract 5016.06, Gloucester County, New Jersey",12,18,0,0,0,0,17,2454,87,2541,764,1714,6977,0,0,353,2642,101,2478,0
34015501608,0.9438752783964365,0.05612472160356347,97,0.3376391982182628,1638,53,23,"Census Tract 5016.08, Gloucester County, New Jersey",758,18,31,0,48,0,0,1900,219,2119,923,702,4978,13,0,358,2245,126,1625,13
34015501609,0.9321948769462581,0.06780512305374184,257,0.005022601707684581,1514,135,167,"Census Tract 5016.09, Gloucester County, New Jersey",10,111,0,0,47,69,30,1455,401,1856,1064,450,5176,0,0,951,1991,135,1514,0
34015501701,0.9951560818083961,0.004843918191603875,10,0.023143164693218515,2471,11,10,"Census Tract 5017.01, Gloucester County, New Jersey",43,0,0,0,0,0,10,1785,64,1849,1165,1306,5019,0,0,184,1858,9,2471,0
34015501702,0.8887733887733887,0.11122661122661123,25,0.006237006237006237,1315,39,33,"Census Tract 5017.02, Gloucester County, New Jersey",6,0,0,0,0,0,25,754,101,855,561,712,2273,7,35,229,962,107,1273,42
34015501703,0.9112709832134293,0.08872901678657075,103,0.0407673860911271,1513,63,23,"Census Tract 5017.03, Gloucester County, New Jersey",68,0,0,21,0,15,67,1373,147,1520,622,891,3688,0,0,469,1668,148,1513,0
34015501704,1,0,24,0.0885182809493265,1843,71,12,"Census Tract 5017.04, Gloucester County, New Jersey",138,0,0,0,0,12,12,1341,218,1559,839,1004,3857,0,0,733,1559,0,1843,0
34015501800,0.9321486268174475,0.06785137318255251,64,0,574,7,2,"Census Tract 5018, Gloucester County, New Jersey",0,0,0,0,0,21,43,459,118,577,157,403,1231,14,0,336,619,42,560,14
34015501900,0.8866498740554156,0.11335012594458438,49,0.12594458438287154,1831,16,32,"Census Tract 5019, Gloucester County, New Jersey",200,17,16,0,16,0,0,1279,129,1408,932,899,3774,0,0,258,1588,180,1831,0
34015502001,0.9698890649762282,0.030110935023771792,196,0,1637,25,97,"Census Tract 5020.01, Gloucester County, New Jersey",0,39,49,9,13,60,26,1592,244,1836,1321,250,5452,66,0,582,1893,57,1571,66
34015502002,0.9562841530054644,0.04371584699453552,71,0,1866,135,28,"Census Tract 5020.02, Gloucester County, New Jersey",0,0,0,37,22,12,0,2273,177,2450,1297,557,6532,0,12,292,2562,112,1854,12
34015502100,0.9302752293577982,0.06972477064220184,14,0.05229357798165138,903,11,15,"Census Tract 5021, Gloucester County, New Jersey",57,0,0,0,0,14,0,994,20,1014,587,316,3114,0,0,36,1090,76,903,0
34015502200,0.9308176100628931,0.06918238993710692,706,0,1184,33,76,"Census Tract 5022, Gloucester County, New Jersey",0,226,34,38,316,92,0,3265,731,3996,952,232,10563,0,0,1666,4293,297,1184,0
34015502300,0.8839724680432645,0.1160275319567355,161,0,584,28,1,"Census Tract 5023, Gloucester County, New Jersey",0,5,10,4,5,53,84,619,280,899,305,242,1638,23,14,942,1017,118,547,37
34015502400,0.9394081728511038,0.060591827148896195,0,0,1868,43,13,"Census Tract 5024, Gloucester County, New Jersey",0,0,0,0,0,0,0,1874,126,2000,1099,695,5616,74,0,305,2129,129,1794,74
34017000100,0.9233023937469468,0.07669760625305325,1562,0,1282,523,992,"Census Tract 1, Hudson County, New Jersey",0,85,89,0,85,339,964,827,1063,1890,525,727,2801,30,0,3465,2047,157,1252,30
34017000200,0.9431407942238267,0.05685920577617329,1980,0.015342960288808664,486,955,1138,"Census Tract 2, Hudson County, New Jersey",34,118,194,285,635,351,397,359,1731,2090,24,96,1112,111,255,4167,2216,126,120,366
34017000300,0.926166568222091,0.07383343177790903,1369,0,1159,598,923,"Census Tract 3, Hudson County, New Jersey",0,165,110,61,169,301,563,488,1080,1568,374,275,1503,390,120,2756,1693,125,649,510
34017000400,0.9652623798965262,0.03473762010347376,1026,0,696,355,674,"Census Tract 4, Hudson County, New Jersey",0,35,129,0,125,187,550,601,705,1306,194,334,1804,123,45,1885,1353,47,528,168
34017000500,0.9431336963097399,0.056866303690260134,1411,0.011494252873563218,552,569,616,"Census Tract 5, Hudson County, New Jersey",19,129,0,0,194,540,548,483,1076,1559,153,254,1550,87,58,2872,1653,94,407,145
34017000600,0.9281696235395932,0.07183037646040676,2039,0,768,946,1093,"Census Tract 6, Hudson County, New Jersey",0,265,323,96,303,332,720,526,1619,2145,173,310,1800,285,0,3970,2311,166,483,285
34017000700,0.8895144264602393,0.11048557353976073,1254,0,239,506,713,"Census Tract 7, Hudson County, New Jersey",0,213,0,88,491,227,235,267,997,1264,74,84,576,67,14,2512,1421,157,158,81
34017000800,0.8837072018890201,0.11629279811097992,1467,0,660,533,1031,"Census Tract 8, Hudson County, New Jersey",0,109,108,141,245,533,331,442,1055,1497,290,174,1119,85,111,2451,1694,197,464,196
34017000902,0.9348920863309352,0.06510791366906475,2660,0,1155,1344,1687,"Census Tract 9.02, Hudson County, New Jersey",0,220,160,1650,210,91,329,529,2070,2599,358,439,1484,293,65,4598,2780,181,797,358
34017001000,0.9195402298850575,0.08045977011494253,688,0,385,331,472,"Census Tract 10, Hudson County, New Jersey",0,78,105,4,79,97,325,188,532,720,67,135,549,141,42,1415,783,63,202,183
34017001100,0.9444971537001897,0.05550284629981025,1718,0,794,646,1323,"Census Tract 11, Hudson County, New Jersey",0,159,159,20,175,517,688,782,1209,1991,456,161,1997,168,9,3366,2108,117,617,177
34017001201,0.9330143540669856,0.06698564593301436,721,0,256,294,630,"Census Tract 12.01, Hudson County, New Jersey",0,93,18,14,181,228,187,175,605,780,81,118,406,28,29,1769,836,56,199,57
34017001202,0.8536585365853658,0.14634146341463414,556,0,215,298,322,"Census Tract 12.02, Hudson County, New Jersey",0,249,15,0,75,133,84,91,434,525,31,4,223,160,20,1096,615,90,35,180
34017001300,0.9048027444253859,0.09519725557461406,1086,0,551,361,792,"Census Tract 13, Hudson County, New Jersey",0,104,208,25,162,303,284,271,784,1055,262,97,697,93,99,2023,1166,111,359,192
34017001400,0.9217665615141956,0.07823343848580441,1485,0,658,426,1049,"Census Tract 14, Hudson County, New Jersey",0,175,103,58,429,388,332,310,1151,1461,42,191,829,308,117,3134,1585,124,233,425
34017001701,0.8284543325526932,0.1715456674473068,1480,0,510,555,856,"Census Tract 17.01, Hudson County, New Jersey",0,145,44,222,335,391,343,418,997,1415,250,58,1465,183,19,2916,1708,293,308,202
34017001800,0.9724137931034482,0.027586206896551724,1516,0.00438871473354232,436,940,1032,"Census Tract 18, Hudson County, New Jersey",7,337,628,53,344,61,93,147,1404,1551,140,20,341,218,58,3544,1595,44,160,276
34017001900,0.8272189349112427,0.1727810650887574,770,0,199,493,471,"Census Tract 19, Hudson County, New Jersey",0,53,155,209,73,119,161,119,580,699,18,144,311,13,24,1161,845,146,162,37
34017002000,0.9011164274322169,0.09888357256778309,1694,0,714,1086,1331,"Census Tract 20, Hudson County, New Jersey",0,199,456,570,160,161,148,123,1572,1695,8,70,427,432,204,3312,1881,186,78,636
34017002200,0.8966244725738397,0.10337552742616034,802,0,260,283,599,"Census Tract 22, Hudson County, New Jersey",0,51,79,7,349,177,139,316,534,850,91,70,709,82,17,966,948,98,161,99
34017002300,0.8897827835880934,0.11021721641190668,1104,0,317,346,929,"Census Tract 23, Hudson County, New Jersey",0,107,33,109,205,406,244,473,633,1106,17,191,1047,0,109,1367,1243,137,208,109
34017002400,0.9082706766917293,0.09172932330827067,1150,0,380,331,1023,"Census Tract 24, Hudson County, New Jersey",0,85,154,177,151,452,131,548,660,1208,111,126,1311,124,19,1306,1330,122,237,143
34017002700,0.934640522875817,0.06535947712418301,1442,0,1180,570,1017,"Census Tract 27, Hudson County, New Jersey",0,33,130,37,343,358,541,628,1231,1859,721,221,2225,54,184,3434,1989,130,942,238
34017002800,0.9342941924544298,0.06570580754557016,2114,0,729,914,1323,"Census Tract 28, Hudson County, New Jersey",0,388,618,465,182,124,337,469,1735,2204,247,71,1189,254,157,4133,2359,155,318,411
34017002900,0.8951911220715166,0.10480887792848335,1375,0,821,735,1068,"Census Tract 29, Hudson County, New Jersey",0,230,560,361,23,71,130,434,1018,1452,369,104,1004,239,109,2501,1622,170,473,348
34017003000,0.923355025307303,0.07664497469269703,1264,0,694,647,804,"Census Tract 30, Hudson County, New Jersey",0,184,147,269,173,303,188,196,1081,1277,241,167,668,133,153,2172,1383,106,408,286
34017003100,0.9268993839835729,0.0731006160164271,2272,0,271,1086,1399,"Census Tract 31, Hudson County, New Jersey",0,180,425,886,376,185,220,317,1940,2257,27,43,824,153,48,4206,2435,178,70,201
34017003500,0.9357976653696498,0.06420233463035019,907,0,236,374,583,"Census Tract 35, Hudson County, New Jersey",0,20,164,225,148,260,90,326,636,962,136,31,676,43,26,1242,1028,66,167,69
34017004000,0.9425465838509317,0.05745341614906832,1447,0.0036231884057971015,1560,436,1007,"Census Tract 40, Hudson County, New Jersey",7,0,0,0,365,299,783,763,1058,1821,1075,329,2523,131,25,2987,1932,111,1404,156
34017004101,0.9009174311926605,0.09908256880733946,2252,0.005871559633027523,939,911,1332,"Census Tract 41.01, Hudson County, New Jersey",16,306,1136,415,35,115,245,635,1820,2455,306,131,1917,135,367,5595,2725,270,437,502
34017004102,0.9624521072796934,0.037547892720306515,1017,0,921,553,612,"Census Tract 41.02, Hudson County, New Jersey",0,152,126,171,106,92,370,344,912,1256,185,365,1197,274,97,2124,1305,49,550,371
34017004200,0.8877605558524853,0.1122394441475147,1552,0,889,639,974,"Census Tract 42, Hudson County, New Jersey",0,200,427,49,123,278,475,369,1292,1661,144,370,1221,363,12,4381,1871,210,514,375
34017004300,0.8679245283018868,0.1320754716981132,804,0,533,374,634,"Census Tract 43, Hudson County, New Jersey",0,103,86,0,86,229,300,283,683,966,27,356,812,52,98,1573,1113,147,383,150
34017004400,0.8196581196581196,0.18034188034188034,935,0,193,526,524,"Census Tract 44, Hudson County, New Jersey",0,24,39,118,224,275,255,192,767,959,2,61,707,11,119,1928,1170,211,63,130
34017004500,0.9149057681324957,0.08509423186750428,1432,0.013135351227869789,737,666,874,"Census Tract 45, Hudson County, New Jersey",23,101,64,61,324,261,621,399,1203,1602,81,398,1130,199,59,2939,1751,149,479,258
34017004600,0.8919202518363064,0.1080797481636936,784,0,518,396,345,"Census Tract 46, Hudson County, New Jersey",0,60,0,0,198,182,344,231,619,850,165,141,717,84,128,1779,953,103,306,212
34017004700,0.874895046179681,0.12510495382031905,957,0,497,326,670,"Census Tract 47, Hudson County, New Jersey",0,85,27,154,180,236,275,190,852,1042,31,285,615,104,77,2142,1191,149,316,181
34017004800,0.8883343730505302,0.11166562694946974,1336,0,570,379,648,"Census Tract 48, Hudson County, New Jersey",0,2,151,46,221,266,650,549,875,1424,191,204,1413,7,168,2377,1603,179,395,175
34017004900,0.9150066401062417,0.0849933598937583,1070,0,957,405,777,"Census Tract 49, Hudson County, New Jersey",0,30,182,12,65,183,598,542,836,1378,324,515,1553,106,12,2310,1506,128,839,118
34017005200,0.8153129849974133,0.18468701500258666,1647,0.0046559751681324365,1313,589,564,"Census Tract 52, Hudson County, New Jersey",9,51,387,63,246,131,769,423,1153,1576,169,677,1147,197,270,3129,1933,357,846,467
34017005300,0.8684640522875817,0.1315359477124183,1053,0,479,274,396,"Census Tract 53, Hudson County, New Jersey",0,15,21,0,140,205,672,381,682,1063,132,239,1090,74,34,2033,1224,161,371,108
34017005400,0.9509727626459143,0.0490272373540856,1328,0,1411,154,1370,"Census Tract 54, Hudson County, New Jersey",0,206,154,32,20,93,823,1524,920,2444,912,429,4475,70,0,2604,2570,126,1341,70
34017005500,0.8962818003913894,0.10371819960861056,850,0,862,361,294,"Census Tract 55, Hudson County, New Jersey",0,32,88,21,73,80,556,268,648,916,185,507,879,81,89,1946,1022,106,692,170
34017005600,0.9178176795580111,0.08218232044198895,1164,0,916,452,654,"Census Tract 56, Hudson County, New Jersey",0,93,187,34,54,114,682,513,816,1329,370,412,1649,88,46,2537,1448,119,782,134
34017005801,0.8373161764705882,0.16268382352941177,1891,0,1040,854,649,"Census Tract 58.01, Hudson County, New Jersey",0,125,153,99,216,342,956,485,1337,1822,380,472,1739,37,151,3825,2176,354,852,188
34017005802,0.924802110817942,0.07519788918205805,535,0,145,21,348,"Census Tract 58.02, Hudson County, New Jersey",0,68,323,115,11,18,0,466,235,701,101,44,1111,0,0,538,758,57,145,0
34017005900,0.8989269643475251,0.1010730356524749,2069,0,2554,418,886,"Census Tract 59, Hudson County, New Jersey",0,199,43,28,236,271,1292,1205,1392,2597,1179,812,4088,322,241,3280,2889,292,1991,563
34017006000,0.7817346352670879,0.2182653647329121,1426,0,1087,581,814,"Census Tract 60, Hudson County, New Jersey",0,58,50,0,311,53,954,434,927,1361,303,490,1403,236,58,2602,1741,380,793,294
34017006100,0.9293203883495146,0.07067961165048543,1695,0,2573,574,739,"Census Tract 61, Hudson County, New Jersey",0,36,22,137,182,115,1203,1142,1251,2393,611,1512,3366,356,94,3854,2575,182,2123,450
34017006200,0.8961916461916462,0.1038083538083538,1341,0,1073,617,734,"Census Tract 62, Hudson County, New Jersey",0,73,36,246,342,207,437,461,998,1459,397,452,1447,224,0,2301,1628,169,849,224
34017006300,0.893305439330544,0.10669456066945607,1597,0,621,657,690,"Census Tract 63, Hudson County, New Jersey",0,78,46,191,251,428,603,607,1101,1708,260,260,2085,83,18,2414,1912,204,520,101
34017006400,0.8540145985401459,0.145985401459854,1493,0,790,682,1344,"Census Tract 64, Hudson County, New Jersey",0,183,132,87,262,550,279,447,957,1404,104,179,984,359,148,1851,1644,240,283,507
34017006500,0.9035933391761612,0.09640666082383874,1021,0,202,344,596,"Census Tract 65, Hudson County, New Jersey",0,47,143,289,165,246,131,365,666,1031,21,71,769,57,53,1317,1141,110,92,110
34017006600,0.9665178571428571,0.033482142857142856,251,0,537,50,289,"Census Tract 66, Hudson County, New Jersey",0,10,32,0,15,60,134,240,193,433,132,282,881,77,46,736,448,15,414,123
34017006700,0.8158995815899581,0.18410041841004185,1111,0,577,580,378,"Census Tract 67, Hudson County, New Jersey",0,380,69,221,164,130,147,115,1055,1170,192,0,335,209,176,2831,1434,264,192,385
34017006800,0.8777078965758212,0.1222921034241789,1197,0,1128,551,698,"Census Tract 68, Hudson County, New Jersey",0,13,77,61,255,163,628,324,932,1256,514,263,998,127,224,2894,1431,175,777,351
34017006900,0.6590909090909091,0.3409090909090909,30,0,4,0,13,"Census Tract 69, Hudson County, New Jersey",0,0,0,9,0,17,4,11,18,29,4,0,42,0,0,30,44,15,4,0
34017007000,0.9152691968225949,0.08473080317740513,1989,0,898,1003,1654,"Census Tract 70, Hudson County, New Jersey",0,100,184,728,385,447,145,438,1636,2074,48,322,1033,440,88,3360,2266,192,370,528
34017007100,0.9082819986310746,0.0917180013689254,1266,0,561,473,1096,"Census Tract 71, Hudson County, New Jersey",0,176,370,87,227,135,271,301,1026,1327,372,43,1005,75,71,2177,1461,134,415,146
34017007200,0.896551724137931,0.10344827586206896,903,0,239,224,739,"Census Tract 72, Hudson County, New Jersey",0,0,107,232,199,227,138,430,532,962,113,85,1071,0,41,1082,1073,111,198,41
34017007300,0.8334421946440235,0.16655780535597647,1482,0,0,326,1220,"Census Tract 73, Hudson County, New Jersey",0,13,100,1254,45,70,0,396,880,1276,0,0,838,0,0,1546,1531,255,0,0
34017007400,0.8344211611130196,0.1655788388869804,2849,0,52,753,2297,"Census Tract 74, Hudson County, New Jersey",0,17,150,2653,0,29,0,544,1885,2429,52,0,1206,0,0,3846,2911,482,52,0
34017007500,0.9124579124579124,0.08754208754208755,3131,0,596,1129,2261,"Census Tract 75, Hudson County, New Jersey",0,263,243,1947,262,394,22,557,2424,2981,65,132,1054,292,107,4949,3267,286,197,399
34017007600,0.8547065337763012,0.1452934662236988,4491,0,29,1530,4145,"Census Tract 76, Hudson County, New Jersey",0,73,47,4166,49,156,0,893,2966,3859,0,0,1975,29,0,5701,4515,656,0,29
34017007700,0.8718318565835566,0.12816814341644345,4839,0,160,2520,4504,"Census Tract 77, Hudson County, New Jersey",0,0,124,4695,20,0,0,659,3572,4231,61,0,1410,74,25,7744,4853,622,61,99
34017007800,0.9272076372315036,0.07279236276849642,818,0,199,403,471,"Census Tract 78, Hudson County, New Jersey",0,238,29,448,54,23,26,8,769,777,17,0,17,137,45,1531,838,61,17,182
34017010100,0.9541052631578948,0.045894736842105266,2073,0,1365,514,740,"Census Tract 101, Hudson County, New Jersey",0,178,84,143,596,159,913,813,1453,2266,726,321,2819,185,133,4096,2375,109,1047,318
34017010200,0.8887171561051005,0.11128284389489954,1069,0,614,156,350,"Census Tract 102, Hudson County, New Jersey",0,83,29,20,59,213,665,555,595,1150,267,321,1387,8,18,1583,1294,144,588,26
34017010300,0.913509060955519,0.08649093904448106,993,0,500,224,312,"Census Tract 103, Hudson County, New Jersey",0,82,113,71,66,147,514,339,770,1109,100,324,1024,50,26,2061,1214,105,424,76
34017010400,0.8964102564102564,0.10358974358974359,1607,0,1191,464,840,"Census Tract 104, Hudson County, New Jersey",0,39,200,412,90,356,510,574,1174,1748,272,517,1603,321,81,2738,1950,202,789,402
34017010500,0.9411764705882353,0.058823529411764705,1687,0,1682,304,877,"Census Tract 105, Hudson County, New Jersey",0,304,358,91,35,252,647,1078,1034,2112,548,866,2466,222,46,2835,2244,132,1414,268
34017010600,0.9539452495974236,0.04605475040257649,2410,0.03993558776167472,1621,890,539,"Census Tract 106, Hudson County, New Jersey",124,260,141,593,139,407,870,1069,1893,2962,391,545,2323,526,159,4894,3105,143,936,685
34017010700,0.8982943777637398,0.10170562223626027,1310,0,538,398,502,"Census Tract 107, Hudson County, New Jersey",0,98,93,11,146,359,603,515,907,1422,126,254,1408,58,100,2250,1583,161,380,158
34017010800,0.9050401753104456,0.09495982468955443,1146,0,800,133,365,"Census Tract 108, Hudson County, New Jersey",0,8,0,3,244,124,767,426,813,1239,258,291,1240,144,107,2319,1369,130,549,251
34017010900,0.9078014184397163,0.09219858156028368,896,0,442,445,321,"Census Tract 109, Hudson County, New Jersey",0,104,68,215,176,169,164,168,728,896,41,224,455,144,33,1561,987,91,265,177
34017011000,0.8354297693920335,0.16457023060796647,877,0,540,210,304,"Census Tract 110, Hudson County, New Jersey",0,119,12,28,150,102,466,205,592,797,67,183,448,262,28,1564,954,157,250,290
34017011100,0.927536231884058,0.07246376811594203,1667,0,1074,444,574,"Census Tract 111, Hudson County, New Jersey",0,101,21,21,323,419,782,309,1355,1664,420,232,1029,181,241,3492,1794,130,652,422
34017011200,0.9252696456086287,0.07473035439137134,1819,0,1479,308,669,"Census Tract 112, Hudson County, New Jersey",0,15,33,69,178,256,1268,1156,1246,2402,467,858,3252,113,41,3077,2596,194,1325,154
34017011300,0.7904612978889758,0.20953870211102424,947,0,804,220,334,"Census Tract 113, Hudson County, New Jersey",0,34,110,44,136,130,493,375,636,1011,296,249,989,187,72,1606,1279,268,545,259
34017011400,0.9217958001448225,0.0782041998551774,931,0,1228,162,347,"Census Tract 114, Hudson County, New Jersey",0,87,35,7,84,147,571,733,540,1273,492,626,2300,16,94,1259,1381,108,1118,110
34017011500,0.8888888888888888,0.1111111111111111,931,0,1293,119,287,"Census Tract 115, Hudson County, New Jersey",0,18,34,0,45,245,589,628,492,1120,501,650,1833,33,109,1135,1260,140,1151,142
34017011600,0.9560148383677796,0.04398516163222046,1565,0,1201,602,424,"Census Tract 116, Hudson County, New Jersey",0,430,334,244,40,108,409,543,1261,1804,166,509,1322,247,279,2646,1887,83,675,526
34017012300,0.976482617586912,0.023517382413087935,633,0,835,121,113,"Census Tract 123, Hudson County, New Jersey",0,50,204,26,47,127,179,380,575,955,328,290,1162,190,27,1304,978,23,618,217
34017012400,0.9299145299145299,0.07008547008547009,346,0,944,52,229,"Census Tract 124, Hudson County, New Jersey",0,39,26,0,67,71,143,912,176,1088,207,654,2570,83,0,402,1170,82,861,83
34017012500,0.9534246575342465,0.04657534246575343,736,0,961,72,228,"Census Tract 125, Hudson County, New Jersey",0,103,89,22,127,105,290,912,480,1392,248,513,2727,140,60,1243,1460,68,761,200
34017012600,0.9221556886227545,0.07784431137724551,900,0.0074850299401197605,865,147,162,"Census Tract 126, Hudson County, New Jersey",10,98,29,8,93,94,578,545,687,1232,277,503,1800,76,9,1902,1336,104,780,85
34017012700,0.9569620253164557,0.043037974683544304,1388,0,1358,248,412,"Census Tract 127, Hudson County, New Jersey",0,63,77,153,209,95,791,858,1032,1890,340,832,2539,125,61,2533,1975,85,1172,186
34017012800,0.8935128518971848,0.10648714810281518,1045,0,820,131,241,"Census Tract 128, Hudson County, New Jersey",0,58,93,34,37,148,675,700,760,1460,271,340,2104,140,69,2311,1634,174,611,209
34017012900,0.921980495123781,0.07801950487621906,874,0,869,131,245,"Census Tract 129, Hudson County, New Jersey",0,48,0,0,40,275,511,601,628,1229,270,405,2021,113,81,1859,1333,104,675,194
34017013000,0.9437299035369775,0.05627009646302251,1053,0,551,257,457,"Census Tract 130, Hudson County, New Jersey",0,67,0,0,207,294,485,319,855,1174,188,88,1101,187,88,2823,1244,70,276,275
34017013100,0.9694444444444444,0.030555555555555555,519,0,491,78,127,"Census Tract 131, Hudson County, New Jersey",0,8,13,28,35,190,245,297,401,698,175,214,943,83,19,1286,720,22,389,102
34017013200,0.9056482670089859,0.09435173299101413,1250,0,1089,271,444,"Census Tract 132, Hudson County, New Jersey",0,170,80,0,121,310,569,511,900,1411,282,450,1496,334,23,2779,1558,147,732,357
34017013300,0.9131944444444444,0.08680555555555555,847,0.013888888888888888,702,149,209,"Census Tract 133, Hudson County, New Jersey",16,90,49,0,140,221,347,372,680,1052,250,299,1177,144,9,1841,1152,100,549,153
34017013400,0.9327521793275217,0.06724782067247821,691,0,541,238,460,"Census Tract 134, Hudson County, New Jersey",0,7,21,15,34,232,382,221,528,749,301,133,797,94,13,1868,803,54,434,107
34017013500,0.947752808988764,0.052247191011235955,1575,0,782,507,670,"Census Tract 135, Hudson County, New Jersey",0,160,96,72,319,385,543,414,1273,1687,286,110,1091,319,67,3988,1780,93,396,386
34017013600,0.9503267973856209,0.04967320261437908,634,0.006535947712418301,657,177,298,"Census Tract 136, Hudson County, New Jersey",5,21,5,0,32,237,339,244,483,727,287,261,831,99,10,1394,765,38,548,109
34017013700,0.9628865979381444,0.03711340206185567,902,0,352,288,360,"Census Tract 137, Hudson County, New Jersey",0,21,58,0,73,282,468,209,725,934,105,86,583,73,88,1903,970,36,191,161
34017013800,0.9467061435973353,0.053293856402664694,1186,0,487,358,816,"Census Tract 138, Hudson County, New Jersey",0,40,58,640,10,174,264,273,1006,1279,149,247,728,91,0,2178,1351,72,396,91
34017013900,0.9417989417989417,0.0582010582010582,1080,0,876,170,583,"Census Tract 139, Hudson County, New Jersey",0,52,0,245,12,264,507,472,774,1246,230,582,1408,33,31,2069,1323,77,812,64
34017014000,0.918918918918919,0.08108108108108109,1488,0.004964147821290678,1039,381,914,"Census Tract 140, Hudson County, New Jersey",9,234,323,94,55,156,626,603,1063,1666,230,311,1606,258,240,3315,1813,147,541,498
34017014101,0.9524987629886195,0.0475012370113805,1922,0,650,334,971,"Census Tract 141.01, Hudson County, New Jersey",0,118,735,874,44,120,31,810,1115,1925,216,68,1750,246,120,1832,2021,96,284,366
34017014102,0.9635983263598327,0.036401673640167366,1785,0.024267782426778243,1270,463,1164,"Census Tract 141.02, Hudson County, New Jersey",58,114,604,499,113,101,354,1066,1237,2303,491,539,2434,189,51,2756,2390,87,1030,240
34017014200,0.9478672985781991,0.052132701421800945,1803,0,1363,348,1203,"Census Tract 142, Hudson County, New Jersey",0,160,326,99,279,399,540,616,1384,2000,497,347,1772,260,259,4173,2110,110,844,519
34017014300,0.9263103269330566,0.07368967306694343,1535,0,1384,279,887,"Census Tract 143, Hudson County, New Jersey",0,156,161,0,57,283,878,721,1064,1785,427,454,2290,304,199,2817,1927,142,881,503
34017014400,0.8992939427722036,0.10070605722779635,1513,0,1923,327,952,"Census Tract 144, Hudson County, New Jersey",0,33,75,19,76,169,1141,1389,1031,2420,699,934,4231,210,80,3386,2691,271,1633,290
34017014501,0.9491686460807601,0.0508313539192399,1674,0,899,422,762,"Census Tract 145.01, Hudson County, New Jersey",0,103,84,163,257,365,702,608,1390,1998,492,131,1762,74,202,4747,2105,107,623,276
34017014502,0.9694742792538157,0.030525720746184284,1651,0,508,770,229,"Census Tract 145.02, Hudson County, New Jersey",0,166,66,877,244,115,183,157,1558,1715,157,0,505,225,126,2833,1769,54,157,351
34017014600,0.899546827794562,0.10045317220543806,1007,0.014350453172205438,581,210,589,"Census Tract 146, Hudson County, New Jersey",19,8,41,100,77,152,629,481,710,1191,389,192,1742,0,0,2011,1324,133,581,0
34017014700,0.9252232142857143,0.07477678571428571,1221,0,1283,292,974,"Census Tract 147, Hudson County, New Jersey",0,144,41,25,63,233,715,808,850,1658,543,364,2696,328,48,3263,1792,134,907,376
34017014800,0.9030674846625767,0.09693251533742331,1993,0.0028629856850715747,1361,555,713,"Census Tract 148, Hudson County, New Jersey",7,142,524,108,149,327,743,814,1394,2208,219,683,2456,248,211,3503,2445,237,902,459
34017014900,0.9537465309898242,0.04625346901017576,856,0,620,197,451,"Census Tract 149, Hudson County, New Jersey",0,38,32,0,48,87,651,439,592,1031,274,231,1610,115,0,1869,1081,50,505,115
34017015001,0.938366718027735,0.061633281972265024,1140,0,368,241,630,"Census Tract 150.01, Hudson County, New Jersey",0,0,25,1055,12,38,10,927,291,1218,148,187,1578,33,0,666,1298,80,335,33
34017015002,0.9615069615069615,0.03849303849303849,2242,0,642,817,1361,"Census Tract 150.02, Hudson County, New Jersey",0,452,113,244,316,607,510,471,1877,2348,173,85,1170,347,37,4806,2442,94,258,384
34017015100,0.9421276595744681,0.05787234042553192,1039,0.01276595744680851,477,277,633,"Census Tract 151, Hudson County, New Jersey",15,236,114,11,90,261,327,315,792,1107,182,134,897,131,30,2209,1175,68,316,161
34017015201,0.946925566343042,0.05307443365695793,1275,0,333,244,1130,"Census Tract 152.01, Hudson County, New Jersey",0,60,61,1134,20,0,0,955,508,1463,117,204,1658,12,0,1079,1545,82,321,12
34017015202,0.9049556213017751,0.09504437869822485,2511,0,1605,981,1938,"Census Tract 152.02, Hudson County, New Jersey",0,206,549,500,436,394,426,609,1838,2447,472,166,1386,421,546,4973,2704,257,638,967
34017015300,0.8997333333333334,0.10026666666666667,1795,0,837,759,1007,"Census Tract 153, Hudson County, New Jersey",0,337,528,81,275,331,243,261,1426,1687,134,227,570,187,289,3678,1875,188,361,476
34017015500,0.9776595744680852,0.022340425531914895,1544,0,990,625,1309,"Census Tract 155, Hudson County, New Jersey",0,104,129,146,189,339,637,495,1343,1838,253,282,1529,342,113,4122,1880,42,535,455
34017015600,0.9189356435643564,0.08106435643564357,1514,0,1226,634,976,"Census Tract 156, Hudson County, New Jersey",0,317,266,110,468,137,216,141,1344,1485,204,125,521,581,316,3906,1616,131,329,897
34017015700,0.8812111801242236,0.1187888198757764,1160,0,688,470,973,"Census Tract 157, Hudson County, New Jersey",0,452,110,0,200,107,291,181,954,1135,66,145,590,342,135,3263,1288,153,211,477
34017015801,0.9409722222222222,0.059027777777777776,1681,0,46,280,1071,"Census Tract 158.01, Hudson County, New Jersey",0,34,157,1471,10,9,0,272,1354,1626,0,0,528,46,0,2772,1728,102,0,46
34017015802,0.9434577745559986,0.05654222544400145,2546,0,1382,1451,1357,"Census Tract 158.02, Hudson County, New Jersey",0,241,516,1099,80,189,421,281,2322,2603,351,31,880,702,298,5268,2759,156,382,1000
34017015900,0.9494949494949495,0.050505050505050504,1863,0,1989,911,1111,"Census Tract 159, Hudson County, New Jersey",0,495,507,134,293,159,275,197,1683,1880,108,367,605,1022,492,5280,1980,100,475,1514
34017016000,0.9205246913580247,0.07947530864197531,1076,0,663,293,607,"Census Tract 160, Hudson County, New Jersey",0,166,187,156,249,110,208,360,833,1193,202,153,1031,108,200,2302,1296,103,355,308
34017016100,0.8862491000719942,0.11375089992800576,1205,0.0028797696184305254,527,797,799,"Census Tract 161, Hudson County, New Jersey",4,197,223,0,333,217,235,178,1053,1231,23,162,637,208,134,2785,1389,158,185,342
34017016200,0.8634538152610441,0.13654618473895583,1596,0,701,815,1012,"Census Tract 162, Hudson County, New Jersey",0,202,370,45,174,429,376,171,1334,1505,96,95,335,361,149,3908,1743,238,191,510
34017016300,0.9748797434526991,0.02512025654730091,1713,0,992,803,1222,"Census Tract 163, Hudson County, New Jersey",0,219,370,312,187,339,286,386,1438,1824,61,212,913,533,186,4112,1871,47,273,719
34017016400,0.9370904325032765,0.06290956749672345,1387,0,784,686,640,"Census Tract 164, Hudson County, New Jersey",0,206,125,188,274,292,302,294,1136,1430,259,82,821,353,90,2739,1526,96,341,443
34017016500,0.9097658480868075,0.09023415191319246,1635,0,1038,641,1152,"Census Tract 165, Hudson County, New Jersey",0,196,128,304,377,309,321,277,1316,1593,387,0,875,637,14,3658,1751,158,387,651
34017016600,0.9745430809399478,0.025456919060052218,1456,0,731,623,801,"Census Tract 166, Hudson County, New Jersey",0,124,172,234,183,288,455,236,1257,1493,58,149,701,425,99,3480,1532,39,207,524
34017016700,0.9078549848942599,0.09214501510574018,634,0,211,258,386,"Census Tract 167, Hudson County, New Jersey",0,185,55,0,104,109,181,180,421,601,92,53,499,39,27,1069,662,61,145,66
34017016800,0.9198113207547169,0.08018867924528301,1213,0,267,649,723,"Census Tract 168, Hudson County, New Jersey",0,172,30,9,406,412,184,102,1068,1170,78,0,308,88,101,3217,1272,102,78,189
34017016900,0.8570342205323194,0.1429657794676806,1264,0,544,561,507,"Census Tract 169, Hudson County, New Jersey",0,61,55,187,144,449,368,204,923,1127,144,259,552,124,17,2473,1315,188,403,141
34017017000,0.9529170931422722,0.04708290685772774,1809,0,618,552,846,"Census Tract 170, Hudson County, New Jersey",0,204,212,287,612,245,249,226,1636,1862,0,171,574,345,102,4544,1954,92,171,447
34017017100,0.8492338111715274,0.15076618882847256,1766,0,1271,542,843,"Census Tract 171, Hudson County, New Jersey",0,174,154,97,189,276,876,475,1243,1718,330,234,1119,429,278,3782,2023,305,564,707
34017017200,0.9580983078162773,0.041901692183722805,1154,0,562,421,846,"Census Tract 172, Hudson County, New Jersey",0,84,108,37,406,376,143,198,991,1189,69,106,489,237,150,2875,1241,52,175,387
34017017300,0.8872377622377622,0.11276223776223776,1051,0.007867132867132868,668,258,584,"Census Tract 173, Hudson County, New Jersey",9,81,118,299,136,211,206,398,617,1015,174,93,682,206,195,1761,1144,129,267,401
34017017400,0.9420289855072463,0.057971014492753624,893,0,594,357,465,"Census Tract 174, Hudson County, New Jersey",0,148,192,72,81,214,186,227,748,975,280,47,798,249,18,2000,1035,60,327,267
34017017500,0.8688302907369845,0.13116970926301555,1338,0,912,567,1170,"Census Tract 175, Hudson County, New Jersey",0,227,185,47,331,259,289,174,1111,1285,202,79,752,335,296,3626,1479,194,281,631
34017017600,0.9227504244482173,0.07724957555178268,1108,0,476,511,610,"Census Tract 176, Hudson County, New Jersey",0,131,64,9,275,380,249,118,969,1087,84,79,566,229,84,3032,1178,91,163,313
34017017700,0.8492343934040048,0.15076560659599528,805,0.002355712603062426,230,313,398,"Census Tract 177, Hudson County, New Jersey",2,131,0,241,182,169,82,128,593,721,0,16,319,130,84,1529,849,128,16,214
34017017800,0.8446142649199417,0.15538573508005823,2535,0,1060,882,993,"Census Tract 178, Hudson County, New Jersey",0,202,342,362,437,851,341,784,1537,2321,277,287,1802,412,84,4536,2748,427,564,496
34017017900,0.9153702551337897,0.08462974486621033,1376,0,368,114,975,"Census Tract 179, Hudson County, New Jersey",0,40,99,1090,6,90,51,402,1069,1471,98,156,971,6,108,2051,1607,136,254,114
34017018000,0.9153605015673981,0.08463949843260188,1753,0,1215,524,1144,"Census Tract 180, Hudson County, New Jersey",0,268,412,295,123,443,212,570,1182,1752,160,309,1395,324,422,2659,1914,162,469,746
34017018100,0.9205539358600583,0.0794460641399417,1113,0,979,306,626,"Census Tract 181, Hudson County, New Jersey",0,105,250,79,122,294,263,378,885,1263,165,175,1129,392,247,1766,1372,109,340,639
34017018200,0.9005927952576379,0.09940720474236206,1872,0,1010,349,1181,"Census Tract 182, Hudson County, New Jersey",0,125,24,252,324,553,594,857,1118,1975,446,358,1962,65,141,2394,2193,218,804,206
34017018301,0.9121915820029027,0.08780841799709724,1371,0,0,285,1240,"Census Tract 183.01, Hudson County, New Jersey",0,0,20,1351,0,0,0,484,773,1257,0,0,1078,0,0,1635,1378,121,0,0
34017018302,0.8897885739991003,0.11021142600089968,2223,0,9,393,2142,"Census Tract 183.02, Hudson County, New Jersey",0,10,278,1926,9,0,0,698,1280,1978,9,0,1415,0,0,2718,2223,245,9,0
34017018400,0.9366380916884085,0.0633619083115915,2419,0,720,800,2456,"Census Tract 184, Hudson County, New Jersey",0,279,494,1211,116,175,144,1019,1494,2513,330,229,2401,78,83,3103,2683,170,559,161
34017018500,0.9392040112817298,0.06079598871827013,3091,0,775,741,2606,"Census Tract 185, Hudson County, New Jersey",0,394,824,1103,391,264,115,880,2117,2997,101,104,1683,219,351,4668,3191,194,205,570
34017018600,0.9835680751173709,0.01643192488262911,1028,0,522,477,1151,"Census Tract 186, Hudson County, New Jersey",0,252,32,9,287,279,169,550,707,1257,152,211,1319,27,132,1308,1278,21,363,159
34017018701,0.8223350253807107,0.17766497461928935,708,0,108,254,563,"Census Tract 187.01, Hudson County, New Jersey",0,38,59,6,166,304,135,153,495,648,40,23,366,5,40,917,788,140,63,45
34017018702,0.9366258741258742,0.06337412587412587,2070,0,310,837,1626,"Census Tract 187.02, Hudson County, New Jersey",0,425,433,186,563,325,138,678,1465,2143,38,156,1372,66,50,2856,2288,145,194,116
34017018800,0.915282392026578,0.08471760797342193,1649,0,666,734,1422,"Census Tract 188, Hudson County, New Jersey",0,232,31,51,360,736,239,559,1094,1653,121,313,1451,160,72,1842,1806,153,434,232
34017018900,0.9346336320506062,0.06536636794939378,1868,0,543,672,1267,"Census Tract 189, Hudson County, New Jersey",0,170,348,539,467,252,92,605,1168,1773,56,98,1437,172,217,2214,1897,124,154,389
34017019000,0.8563786008230453,0.14362139917695474,2400,0,843,1092,931,"Census Tract 190, Hudson County, New Jersey",0,173,593,665,630,339,0,355,1726,2081,107,65,588,404,267,4229,2430,349,172,671
34017019100,0.9401228249744115,0.059877175025588536,1932,0,327,689,1650,"Census Tract 191, Hudson County, New Jersey",0,130,274,314,806,281,127,699,1138,1837,247,0,1414,66,14,2102,1954,117,247,80
34017019200,0.9479768786127167,0.05202312138728324,2012,0,154,570,2103,"Census Tract 192, Hudson County, New Jersey",0,295,216,557,667,151,126,1046,922,1968,65,72,2237,17,0,1790,2076,108,137,17
34017019300,0.9402271368798566,0.05977286312014345,1640,0,276,761,1379,"Census Tract 193, Hudson County, New Jersey",0,52,303,526,302,367,90,328,1245,1573,35,21,661,105,115,2254,1673,100,56,220
34017019400,0.8849665246500305,0.11503347534996956,1603,0,715,515,969,"Census Tract 194, Hudson County, New Jersey",0,96,166,742,310,254,35,170,1284,1454,7,0,362,427,281,2431,1643,189,7,708
34017019800,0.9525807805287453,0.04741921947125472,1138,0,1482,185,815,"Census Tract 198, Hudson County, New Jersey",0,196,48,29,136,171,558,1605,665,2270,617,732,4867,74,59,1755,2383,113,1349,133
34017019900,0.9701553556827474,0.029844644317252658,1898,0,1595,243,1028,"Census Tract 199, Hudson County, New Jersey",0,182,0,791,50,438,437,1368,1005,2373,620,749,3373,163,63,2121,2446,73,1369,226
34017020000,0.9319955406911928,0.06800445930880714,687,0.0189520624303233,1783,141,360,"Census Tract 200, Hudson County, New Jersey",34,10,0,103,0,51,523,1088,584,1672,883,757,2832,106,37,1399,1794,122,1640,143
34017020100,0.8376511226252159,0.16234887737478412,1158,0,10,25,765,"Census Tract 201, Hudson County, New Jersey",0,5,37,1050,17,15,34,5,965,970,10,0,10,0,0,2269,1158,188,10,0
34017032400,0.9470417873396773,0.05295821266032271,2221,0,1181,993,956,"Census Tract 324, Hudson County, New Jersey",0,156,222,336,238,564,705,439,1850,2289,193,421,1378,552,15,5148,2417,128,614,567
34017980100,NaN,NaN,0,NaN,0,0,0,"Census Tract 9801, Hudson County, New Jersey",0,0,0,0,0,0,0,0,0,0,0,0,0,0,0,0,0,0,0,0
34019010100,0.8985507246376812,0.10144927536231885,96,0,2157,26,113,"Census Tract 101, Hunterdon County, New Jersey",0,14,0,0,0,62,20,2054,54,2108,1032,1125,5747,0,0,83,2346,238,2157,0
34019010200,0.8963978323238763,0.10360216767612368,175,0.008288173414089895,2846,22,44,"Census Tract 102, Hunterdon County, New Jersey",26,0,0,22,9,0,144,2558,254,2812,1167,1640,6660,32,7,552,3137,325,2807,39
34019010300,0.9043358568479009,0.0956641431520991,589,0.011011699931176875,808,86,35,"Census Tract 103, Hunterdon County, New Jersey",16,271,36,42,76,117,47,887,427,1314,458,322,2094,6,22,700,1453,139,780,28
34019010400,0.9316195372750643,0.06838046272493574,83,0.0010282776349614395,2095,78,9,"Census Tract 104, Hunterdon County, New Jersey",2,0,0,0,10,19,54,1659,153,1812,1202,858,4321,17,18,305,1945,133,2060,35
34019010500,0.883410138248848,0.11658986175115207,87,0,2152,74,54,"Census Tract 105, Hunterdon County, New Jersey",0,0,0,0,20,48,19,1797,120,1917,1272,817,4905,63,0,244,2170,253,2089,63
34019010600,0.9290350497620078,0.07096495023799221,177,0,2464,57,49,"Census Tract 106, Hunterdon County, New Jersey",0,6,8,0,22,68,73,1859,288,2147,1107,1317,5391,13,27,645,2311,164,2424,40
34019010701,0.9749455337690632,0.02505446623093682,379,0.010893246187363835,1528,20,41,"Census Tract 107.01, Hunterdon County, New Jersey",20,257,11,0,61,42,8,1544,246,1790,934,562,4157,0,32,505,1836,46,1496,32
34019010702,0.9275578790141897,0.07244212098581031,92,0.012696041822255415,1482,23,40,"Census Tract 107.02, Hunterdon County, New Jersey",17,0,0,0,0,22,70,1089,153,1242,626,781,2955,35,40,287,1339,97,1407,75
34019010801,0.9860335195530726,0.013966480446927373,356,0,764,84,83,"Census Tract 108.01, Hunterdon County, New Jersey",0,58,45,23,27,107,96,729,330,1059,521,196,2050,19,28,626,1074,15,717,47
34019010802,0.9508196721311475,0.04918032786885246,353,0,345,7,39,"Census Tract 108.02, Hunterdon County, New Jersey",0,78,115,3,61,59,37,476,336,812,182,163,1047,0,0,885,854,42,345,0
34019010900,0.9459635416666666,0.054036458333333336,201,0.018229166666666668,1034,94,96,"Census Tract 109, Hunterdon County, New Jersey",28,19,0,9,22,17,134,1116,337,1453,537,470,2819,0,27,708,1536,83,1007,27
34019011001,0.9325842696629213,0.06741573033707865,136,0,1639,2,46,"Census Tract 110.01, Hunterdon County, New Jersey",0,41,0,6,50,23,16,1340,237,1577,993,584,3932,62,0,673,1691,114,1577,62
34019011002,0.9822784810126582,0.017721518987341773,417,0,2196,41,86,"Census Tract 110.02, Hunterdon County, New Jersey",0,106,22,0,202,39,48,2084,244,2328,1307,856,5300,33,0,481,2370,42,2163,33
34019011100,0.9750623441396509,0.02493765586034913,460,0.005403158769742311,2068,106,83,"Census Tract 111, Hunterdon County, New Jersey",13,78,113,24,76,89,80,2097,249,2346,1273,795,4806,0,0,464,2406,60,2068,0
34019011201,1,0,44,0,3265,58,175,"Census Tract 112.01, Hunterdon County, New Jersey",0,0,0,0,0,0,44,2384,125,2509,2158,1018,6938,0,89,266,2509,0,3176,89
34019011202,0.953000723065799,0.046999276934201015,359,0,1388,8,57,"Census Tract 112.02, Hunterdon County, New Jersey",0,9,0,16,265,55,14,1108,210,1318,976,405,2840,0,7,542,1383,65,1381,7
34019011301,0.934084272006675,0.06591572799332499,250,0.0196078431372549,2208,123,73,"Census Tract 113.01, Hunterdon County, New Jersey",47,0,57,55,11,45,82,1958,281,2239,1440,747,5530,21,0,603,2397,158,2187,21
34019011302,0.9943161634103019,0.005683836589698046,260,0,1636,76,179,"Census Tract 113.02, Hunterdon County, New Jersey",0,53,30,24,43,82,28,2474,325,2799,1176,444,6636,0,16,873,2815,16,1620,16
34019011303,1,0,466,0,1666,18,0,"Census Tract 113.03, Hunterdon County, New Jersey",0,118,14,14,263,57,0,1629,412,2041,1076,477,3939,113,0,691,2041,0,1553,113
34019011304,0.9589519650655022,0.04104803493449782,25,0,1406,49,106,"Census Tract 113.04, Hunterdon County, New Jersey",0,0,0,0,0,7,18,1080,18,1098,783,623,3425,0,0,34,1145,47,1406,0
34019011400,0.8771929824561403,0.12280701754385964,1355,0,676,318,40,"Census Tract 114, Hunterdon County, New Jersey",0,400,37,135,98,381,304,634,1216,1850,164,349,1601,152,11,2904,2109,259,513,163
34019011500,0.936049265750829,0.06395073424917101,335,0.0047370914258645196,1882,155,47,"Census Tract 115, Hunterdon County, New Jersey",10,40,3,0,69,115,108,1547,429,1976,1106,615,4117,33,128,912,2111,135,1721,161
34019011600,0.9314079422382672,0.06859205776173286,117,0,2054,5,106,"Census Tract 116, Hunterdon County, New Jersey",0,0,0,0,19,47,51,1712,352,2064,724,1251,4466,79,0,655,2216,152,1975,79
34019011700,0.9174816625916871,0.08251833740831296,26,0.006723716381418093,1973,91,23,"Census Tract 117, Hunterdon County, New Jersey",11,0,0,8,0,0,18,1382,119,1501,879,1056,3536,38,0,326,1636,135,1935,38
34019011800,0.9534467323187108,0.046553267681289166,39,0,991,22,28,"Census Tract 118, Hunterdon County, New Jersey",0,0,0,0,6,17,16,958,107,1065,473,508,2522,5,5,252,1117,52,981,10
34019011900,0.9141944317663168,0.08580556823368325,805,0,1231,33,82,"Census Tract 119, Hunterdon County, New Jersey",0,95,66,112,65,240,227,1135,868,2003,575,526,2393,130,0,1394,2191,188,1101,130
34021000100,0.8883174136664217,0.11168258633357825,457,0,635,314,68,"Census Tract 1, Mercer County, New Jersey",0,0,15,209,37,28,168,458,751,1209,240,374,865,6,15,2416,1361,152,614,21
34021000200,0.7985294117647059,0.20147058823529412,170,0,829,256,145,"Census Tract 2, Mercer County, New Jersey",0,0,7,63,0,80,20,530,556,1086,248,384,1701,197,0,2292,1360,274,632,197
34021000300,0.8429591174561972,0.15704088254380272,289,0.0136275146009085,608,206,235,"Census Tract 3, Mercer County, New Jersey",21,0,0,0,30,54,205,697,602,1299,304,237,1941,57,10,2143,1541,242,541,67
34021000400,0.7417582417582418,0.25824175824175827,726,0,368,403,83,"Census Tract 4, Mercer County, New Jersey",0,50,35,42,107,170,322,334,1016,1350,215,82,1076,43,28,3576,1820,470,297,71
34021000500,0.8464673913043478,0.15353260869565216,402,0,459,170,49,"Census Tract 5, Mercer County, New Jersey",0,19,29,0,74,114,166,371,875,1246,95,336,1228,11,17,3586,1472,226,431,28
34021000600,0.8526522593320236,0.14734774066797643,129,0,583,125,53,"Census Tract 6, Mercer County, New Jersey",0,0,0,0,21,11,97,989,313,1302,436,147,3314,0,0,1344,1527,225,583,0
34021000700,0.8925992779783394,0.10740072202166065,388,0,250,262,60,"Census Tract 7, Mercer County, New Jersey",0,25,0,7,29,17,310,280,709,989,0,250,910,0,0,2614,1108,119,250,0
34021000800,0.8660022148394242,0.13399778516057587,436,0,296,189,64,"Census Tract 8, Mercer County, New Jersey",0,0,15,112,58,94,157,222,560,782,108,173,599,0,15,1641,903,121,281,15
34021000900,0.7048222113979542,0.2951777886020458,1471,0,412,676,186,"Census Tract 9, Mercer County, New Jersey",0,85,97,345,167,521,256,311,1136,1447,51,219,686,0,142,2394,2053,606,270,142
34021001000,0.7579022988505747,0.24209770114942528,779,0,232,502,81,"Census Tract 10, Mercer County, New Jersey",0,76,0,405,111,95,92,146,909,1055,16,65,307,151,0,2222,1392,337,81,151
34021001101,0.8371212121212122,0.16287878787878787,831,0,703,386,81,"Census Tract 11.01, Mercer County, New Jersey",0,78,11,544,81,63,54,289,816,1105,211,287,960,74,131,1566,1320,215,498,205
34021001102,0.7541073384446878,0.24589266155531217,1024,0,619,750,94,"Census Tract 11.02, Mercer County, New Jersey",0,45,61,591,108,99,120,248,1129,1377,306,159,683,83,71,2629,1826,449,465,154
34021001200,0.8381006864988558,0.16189931350114417,718,0,1072,292,298,"Census Tract 12, Mercer County, New Jersey",0,170,78,56,121,125,168,809,656,1465,357,698,2451,0,17,1555,1748,283,1055,17
34021001300,0.8448652585579024,0.1551347414420976,265,0,1442,146,84,"Census Tract 13, Mercer County, New Jersey",0,39,22,32,39,98,35,762,398,1160,530,912,2116,0,0,1157,1373,213,1442,0
34021001401,0.8809776833156217,0.11902231668437832,1084,0,516,807,296,"Census Tract 14.01, Mercer County, New Jersey",0,97,136,499,279,3,70,323,1335,1658,224,204,720,34,54,3158,1882,224,428,88
34021001402,0.584305408271474,0.41569459172852596,206,0,550,157,46,"Census Tract 14.02, Mercer County, New Jersey",0,0,0,0,10,83,113,297,254,551,67,477,1007,6,0,866,943,392,544,6
34021001500,0.7026657552973342,0.29733424470266573,385,0,371,453,186,"Census Tract 15, Mercer County, New Jersey",0,44,94,47,39,116,45,337,691,1028,167,98,806,12,94,2045,1463,435,265,106
34021001600,0.7101910828025477,0.2898089171974522,222,0,194,140,17,"Census Tract 16, Mercer County, New Jersey",0,39,34,7,0,72,70,161,285,446,63,4,457,76,51,699,628,182,67,127
34021001700,0.7142857142857143,0.2857142857142857,637,0,910,538,246,"Census Tract 17, Mercer County, New Jersey",0,218,16,36,126,98,143,377,898,1275,153,332,1033,164,261,2366,1785,510,485,425
34021001800,0.9256198347107438,0.0743801652892562,239,0,989,132,148,"Census Tract 18, Mercer County, New Jersey",0,64,35,0,67,30,43,527,817,1344,287,516,1125,174,12,2626,1452,108,803,186
34021001900,0.7323232323232324,0.2676767676767677,95,0,266,92,21,"Census Tract 19, Mercer County, New Jersey",0,17,0,0,0,25,53,140,295,435,116,95,392,0,55,1274,594,159,211,55
34021002000,0.7736842105263158,0.22631578947368422,168,0,286,123,68,"Census Tract 20, Mercer County, New Jersey",0,10,13,62,0,19,64,127,314,441,141,24,486,41,80,825,570,129,165,121
34021002100,0.7271157167530224,0.27288428324697755,1244,0,793,655,170,"Census Tract 21, Mercer County, New Jersey",0,29,80,671,70,229,165,484,1200,1684,177,519,1410,46,51,3067,2316,632,696,97
34021002200,0.7968451242829828,0.2031548757170172,468,0,1870,427,189,"Census Tract 22, Mercer County, New Jersey",0,0,34,33,40,146,215,813,854,1667,876,446,2733,147,401,2863,2092,425,1322,548
34021002400,NaN,NaN,0,NaN,0,0,0,"Census Tract 24, Mercer County, New Jersey",0,0,0,0,0,0,0,0,0,0,0,0,0,0,0,0,0,0,0,0
34021002500,0.9228453142642078,0.07715468573579225,422,0,2481,55,224,"Census Tract 25, Mercer County, New Jersey",0,19,0,13,82,65,243,1868,584,2452,1026,1315,5104,34,106,1647,2657,205,2341,140
34021002601,0.907860824742268,0.09213917525773196,249,0,708,121,60,"Census Tract 26.01, Mercer County, New Jersey",0,8,7,0,78,8,148,965,444,1409,435,263,2909,10,0,1639,1552,143,698,10
34021002602,0.9661222020568663,0.0338777979431337,475,0,1220,133,193,"Census Tract 26.02, Mercer County, New Jersey",0,157,22,50,53,121,72,990,607,1597,481,602,2854,98,39,1401,1653,56,1083,137
34021002701,0.9366065879428216,0.06339341205717837,628,0,614,153,72,"Census Tract 27.01, Mercer County, New Jersey",0,70,59,75,142,127,155,766,741,1507,195,404,2342,8,7,1744,1609,102,599,15
34021002702,0.8867924528301887,0.11320754716981132,1532,0,2062,432,45,"Census Tract 27.02, Mercer County, New Jersey",0,468,59,580,176,63,186,1170,1556,2726,709,1049,3139,217,87,2443,3074,348,1758,304
34021002800,1,0,447,0,1449,189,222,"Census Tract 28, Mercer County, New Jersey",0,104,62,34,0,84,163,1186,929,2115,861,451,4350,137,0,3479,2115,0,1312,137
34021002902,0.9103043246129204,0.08969567538707955,714,0,1411,95,130,"Census Tract 29.02, Mercer County, New Jersey",0,261,52,84,91,75,151,967,738,1705,548,758,2737,81,24,1717,1873,168,1306,105
34021002903,0.8713178294573644,0.12868217054263567,227,0,1033,75,107,"Census Tract 29.03, Mercer County, New Jersey",0,23,152,0,0,0,52,883,241,1124,468,553,2394,0,12,874,1290,166,1021,12
34021002904,0.9652173913043478,0.034782608695652174,208,0,2351,44,116,"Census Tract 29.04, Mercer County, New Jersey",0,61,20,53,36,38,0,1621,266,1887,1106,1155,4458,20,70,452,1955,68,2261,90
34021003001,0.9384893713251922,0.06151062867480778,159,0,2075,19,53,"Census Tract 30.01, Mercer County, New Jersey",0,73,0,20,0,21,45,1838,237,2075,718,1337,4859,20,0,619,2211,136,2055,20
34021003002,0.9859989229940764,0.014001077005923533,126,0,2596,29,56,"Census Tract 30.02, Mercer County, New Jersey",0,0,62,54,0,10,0,1682,149,1831,1241,1292,4960,0,63,271,1857,26,2533,63
34021003003,0.9547563805104409,0.04524361948955916,442,0,2670,51,33,"Census Tract 30.03, Mercer County, New Jersey",0,101,95,43,38,87,78,1976,493,2469,970,1579,5521,43,78,807,2586,117,2549,121
34021003004,0.9286618826509075,0.07133811734909244,442,0,1824,120,53,"Census Tract 30.04, Mercer County, New Jersey",0,156,38,39,26,21,162,1821,379,2200,682,914,4409,205,23,866,2369,169,1596,228
34021003006,0.9682614874467077,0.03173851255329228,51,0,2705,136,78,"Census Tract 30.06, Mercer County, New Jersey",0,0,0,11,0,31,9,1926,118,2044,1011,1694,5423,0,0,174,2111,67,2705,0
34021003007,0.9367816091954023,0.06321839080459771,6,0,1684,7,24,"Census Tract 30.07, Mercer County, New Jersey",0,0,0,0,0,0,6,1091,50,1141,962,646,3119,54,22,182,1218,77,1608,76
34021003008,0.9672544080604534,0.0327455919395466,408,0,1840,116,115,"Census Tract 30.08, Mercer County, New Jersey",0,197,0,55,68,58,30,1451,469,1920,784,865,3846,147,44,926,1985,65,1649,191
34021003009,0.9460625674217907,0.05393743257820928,1522,0,1385,244,61,"Census Tract 30.09, Mercer County, New Jersey",0,828,351,135,117,43,48,1778,853,2631,862,362,3741,115,46,1831,2781,150,1224,161
34021003100,0.9481157837247406,0.05188421627525942,568,0,1224,157,77,"Census Tract 31, Mercer County, New Jersey",0,137,82,71,138,63,77,1146,590,1736,481,653,3336,90,0,1204,1831,95,1134,90
34021003201,0.9481420988158432,0.0518579011841568,559,0,1538,55,50,"Census Tract 32.01, Mercer County, New Jersey",0,261,31,48,96,72,51,1510,812,2322,754,708,4074,66,10,2097,2449,127,1462,76
34021003202,0.9463993453355155,0.05360065466448445,722,0,2120,95,227,"Census Tract 32.02, Mercer County, New Jersey",0,149,19,270,212,36,36,1718,595,2313,1236,855,4463,14,15,1042,2444,131,2091,29
34021003301,0.9619457313037724,0.03805426869622766,770,0,1978,111,283,"Census Tract 33.01, Mercer County, New Jersey",0,421,0,30,228,44,47,2220,687,2907,1114,832,5440,32,0,1023,3022,115,1946,32
34021003302,0.8760571595217265,0.12394284047827354,1542,0,1007,72,362,"Census Tract 33.02, Mercer County, New Jersey",0,645,254,242,338,32,31,1637,1367,3004,499,447,4657,61,0,3232,3429,425,946,61
34021003400,0.8944392082940622,0.1055607917059378,162,0,1175,72,35,"Census Tract 34, Mercer County, New Jersey",0,0,0,21,5,48,88,810,139,949,692,437,2054,9,37,259,1061,112,1129,46
34021003500,0.9011908593498552,0.09880914065014483,899,0.012552301255230125,2409,335,186,"Census Tract 35, Mercer County, New Jersey",39,222,190,169,53,125,140,1899,901,2800,957,1252,5225,128,72,1589,3107,307,2209,200
34021003601,0.88125,0.11875,569,0,1018,107,84,"Census Tract 36.01, Mercer County, New Jersey",0,75,60,80,18,163,173,696,573,1269,428,473,2230,79,38,1423,1440,171,901,117
34021003602,0.9273127753303965,0.07268722466960352,351,0,1302,58,16,"Census Tract 36.02, Mercer County, New Jersey",0,91,7,74,79,8,92,812,451,1263,457,791,2280,15,39,1320,1362,99,1248,54
34021003703,0.9073950699533644,0.09260493004663557,170,0,1314,47,120,"Census Tract 37.03, Mercer County, New Jersey",0,60,42,0,40,0,28,1076,286,1362,534,780,3024,0,0,814,1501,139,1314,0
34021003704,0.8751027115858668,0.12489728841413311,435,0,792,30,81,"Census Tract 37.04, Mercer County, New Jersey",0,139,193,75,16,6,6,873,192,1065,451,328,2323,0,13,447,1217,152,779,13
34021003705,0.8803875709989977,0.11961242900100234,1289,0,1652,78,91,"Census Tract 37.05, Mercer County, New Jersey",0,767,89,156,118,13,146,1678,957,2635,737,812,3609,103,0,2070,2993,358,1549,103
34021003706,0.9511254019292604,0.04887459807073955,310,0,1034,0,17,"Census Tract 37.06, Mercer County, New Jersey",0,204,11,13,18,0,64,1129,350,1479,643,348,2711,32,11,803,1555,76,991,43
34021003800,0.9267844002943341,0.07321559970566593,172,0,3415,33,155,"Census Tract 38, Mercer County, New Jersey",0,0,0,0,21,66,85,2285,234,2519,2078,1337,6190,0,0,639,2718,199,3415,0
34021003902,0.9828947368421053,0.017105263157894738,93,0,583,13,24,"Census Tract 39.02, Mercer County, New Jersey",0,0,0,0,2,40,51,584,163,747,244,302,1524,29,8,416,760,13,546,37
34021003903,0.9371980676328503,0.06280193236714976,205,0,775,116,80,"Census Tract 39.03, Mercer County, New Jersey",0,5,8,130,10,34,18,708,262,970,479,296,1990,0,0,472,1035,65,775,0
34021003904,0.951973951973952,0.04802604802604803,257,0,2183,137,221,"Census Tract 39.04, Mercer County, New Jersey",0,49,72,109,27,0,0,2128,211,2339,1875,282,5566,26,0,341,2457,118,2157,26
34021003905,0.9310915104740904,0.0689084895259096,0,0,1456,9,169,"Census Tract 39.05, Mercer County, New Jersey",0,0,0,0,0,0,0,1529,160,1689,631,766,4542,59,0,341,1814,125,1397,59
34021004000,0.9160919540229885,0.0839080459770115,1229,0,718,508,303,"Census Tract 40, Mercer County, New Jersey",0,168,94,69,251,383,264,832,1559,2391,242,332,2213,82,62,3265,2610,219,574,144
34021004201,0.9585190263969832,0.0414809736030168,488,0,1847,247,390,"Census Tract 42.01, Mercer County, New Jersey",0,38,0,125,252,34,39,1884,912,2796,568,1213,5063,24,42,2642,2917,121,1781,66
34021004203,0.8982951205173427,0.10170487948265726,154,0,1049,39,304,"Census Tract 42.03, Mercer County, New Jersey",0,70,7,24,21,23,9,1209,319,1528,652,369,3117,28,0,867,1701,173,1021,28
34021004204,0.8792569659442725,0.12074303405572756,597,0,968,149,521,"Census Tract 42.04, Mercer County, New Jersey",0,83,121,118,61,176,38,1324,664,1988,539,282,3475,147,0,1792,2261,273,821,147
34021004301,0.9501173708920188,0.04988262910798122,1907,0,823,84,969,"Census Tract 43.01, Mercer County, New Jersey",0,1212,305,70,264,44,12,1438,1800,3238,367,338,4354,118,0,4361,3408,170,705,118
34021004304,0.9434812760055479,0.05651872399445215,135,0,2680,54,1126,"Census Tract 43.04, Mercer County, New Jersey",0,19,19,18,20,0,59,2530,191,2721,2131,503,7734,46,0,327,2884,163,2634,46
34021004306,0.9438517686692869,0.05614823133071308,204,0,1231,0,578,"Census Tract 43.06, Mercer County, New Jersey",0,60,17,0,81,36,10,1498,183,1681,833,379,4709,0,19,647,1781,100,1212,19
34021004307,0.9269044473800088,0.07309555261999119,607,0,1791,59,709,"Census Tract 43.07, Mercer County, New Jersey",0,386,65,109,34,0,13,1525,580,2105,904,868,4352,19,0,1275,2271,166,1772,19
34021004309,0.9524456521739131,0.04755434782608696,141,0,1684,40,158,"Census Tract 43.09, Mercer County, New Jersey",0,23,45,0,67,0,6,1242,160,1402,1099,585,4180,0,0,303,1472,70,1684,0
34021004310,0.9691407289172652,0.03085927108273477,713,0.035115722266560255,1848,234,335,"Census Tract 43.10, Mercer County, New Jersey",132,200,151,104,171,47,40,3143,500,3643,1364,470,8611,14,0,1121,3759,116,1834,14
34021004403,0.9211520302171861,0.07884796978281397,731,0,1253,190,27,"Census Tract 44.03, Mercer County, New Jersey",0,240,35,55,156,181,64,1196,755,1951,383,828,3033,42,0,2279,2118,167,1211,42
34021004404,0.8819417475728155,0.11805825242718447,699,0,2269,130,58,"Census Tract 44.04, Mercer County, New Jersey",0,295,35,14,189,127,39,1673,598,2271,967,1231,5168,57,14,1899,2575,304,2198,71
34021004405,0.9422251568174315,0.0577748431825685,996,0.005282271376691978,757,449,359,"Census Tract 44.05, Mercer County, New Jersey",16,252,174,357,107,35,71,1886,968,2854,575,101,5882,33,48,2235,3029,175,676,81
34021004406,0.9047422680412371,0.09525773195876289,1311,0.07711340206185567,843,265,67,"Census Tract 44.06, Mercer County, New Jersey",187,785,53,169,155,45,104,1161,1033,2194,417,236,2555,42,148,2431,2425,231,653,190
34021004407,0.9554794520547946,0.04452054794520548,972,0,1601,27,415,"Census Tract 44.07, Mercer County, New Jersey",0,455,144,53,113,163,44,1280,952,2232,750,731,4104,42,78,2927,2336,104,1481,120
34021004501,0.8294663573085846,0.17053364269141533,299,0,394,123,75,"Census Tract 45.01, Mercer County, New Jersey",0,84,84,7,59,45,20,354,361,715,179,137,1003,41,37,721,862,147,316,78
34021004502,0.8604294478527608,0.13957055214723926,299,0.007668711656441718,233,100,53,"Census Tract 45.02, Mercer County, New Jersey",5,48,77,153,0,0,21,310,251,561,107,110,822,6,10,356,652,91,217,16
34023000100,0.9854492542742815,0.014550745725718442,234,0.006911604219716261,3459,117,172,"Census Tract 1, Middlesex County, New Jersey",19,84,32,42,35,24,17,2207,502,2709,1668,1678,6351,0,113,1268,2749,40,3346,113
34023000200,0.9281262982966348,0.07187370170336518,626,0,1994,144,198,"Census Tract 2, Middlesex County, New Jersey",0,62,223,119,56,59,107,1320,914,2234,608,1256,3661,105,25,2358,2407,173,1864,130
34023000300,0.9407407407407408,0.05925925925925926,955,0,1878,59,225,"Census Tract 3, Middlesex County, New Jersey",0,77,17,0,100,191,570,1749,791,2540,243,1617,4700,0,18,2553,2700,160,1860,18
34023000401,0.9769736842105263,0.023026315789473683,104,0,1253,24,210,"Census Tract 4.01, Middlesex County, New Jersey",0,13,42,0,11,24,14,953,235,1188,573,568,3080,83,29,524,1216,28,1141,112
34023000403,0.9615749525616698,0.03842504743833017,648,0,803,35,303,"Census Tract 4.03, Middlesex County, New Jersey",0,65,107,52,272,95,57,1454,573,2027,349,426,3945,0,28,1759,2108,81,775,28
34023000404,0.9265477439664218,0.07345225603357818,789,0.0026232948583420775,1453,86,71,"Census Tract 4.04, Middlesex County, New Jersey",5,190,27,84,128,313,47,977,789,1766,633,730,2931,56,34,1768,1906,140,1363,90
34023000501,0.9446233097231166,0.05537669027688345,131,0,2043,24,126,"Census Tract 5.01, Middlesex County, New Jersey",0,0,0,0,0,101,30,1168,299,1467,651,1099,3637,34,259,863,1553,86,1750,293
34023000502,0.8946768060836502,0.10532319391634981,1893,0,711,213,175,"Census Tract 5.02, Middlesex County, New Jersey",0,776,325,194,159,141,298,554,1799,2353,179,395,1747,117,20,4432,2630,277,574,137
34023000603,0.9925705794947994,0.007429420505200594,29,0,1016,13,112,"Census Tract 6.03, Middlesex County, New Jersey",0,0,0,0,0,14,15,635,33,668,594,422,1929,0,0,69,673,5,1016,0
34023000606,0.9754473574698294,0.02455264253017062,578,0,2354,25,480,"Census Tract 6.06, Middlesex County, New Jersey",0,32,63,0,327,80,76,1912,432,2344,1298,1056,5749,0,0,1334,2403,59,2354,0
34023000608,0.9506578947368421,0.049342105263157895,229,0,397,5,38,"Census Tract 6.08, Middlesex County, New Jersey",0,148,17,5,59,0,0,314,264,578,185,193,926,13,6,812,608,30,378,19
34023000701,0.965675057208238,0.034324942791762014,554,0,1161,49,158,"Census Tract 7.01, Middlesex County, New Jersey",0,264,65,102,37,62,24,674,592,1266,722,324,2239,95,20,1113,1311,45,1046,115
34023000702,0.9553133514986376,0.0446866485013624,183,0,1947,99,131,"Census Tract 7.02, Middlesex County, New Jersey",0,0,0,106,6,40,31,1522,231,1753,1084,768,4767,69,26,392,1835,82,1852,95
34023000801,0.9488158899923606,0.05118411000763942,29,0,1909,23,87,"Census Tract 8.01, Middlesex County, New Jersey",0,0,0,0,0,0,29,1154,88,1242,850,1049,3600,10,0,457,1309,67,1899,10
34023000802,0.9609292502639916,0.03907074973600845,118,0,1019,20,45,"Census Tract 8.02, Middlesex County, New Jersey",0,18,0,5,0,5,90,738,172,910,357,656,2144,6,0,671,947,37,1013,6
34023000901,0.9821200510855683,0.017879948914431672,9,0,1090,17,80,"Census Tract 9.01, Middlesex County, New Jersey",0,0,0,0,0,0,9,733,36,769,539,551,2338,0,0,52,783,14,1090,0
34023000902,0.9789283564118001,0.02107164358819988,172,0,1941,88,108,"Census Tract 9.02, Middlesex County, New Jersey",0,0,29,102,0,24,17,1365,261,1626,908,1025,3763,8,0,726,1661,35,1933,8
34023001001,0.9471910112359551,0.052808988764044947,29,0,799,23,68,"Census Tract 10.01, Middlesex County, New Jersey",0,0,0,0,0,0,29,793,50,843,359,431,2368,0,9,176,890,47,790,9
34023001002,0.9678052610914801,0.03219473890851983,717,0,2730,43,335,"Census Tract 10.02, Middlesex County, New Jersey",0,345,131,36,138,33,34,1738,727,2465,1400,1299,5514,15,16,1806,2547,82,2699,31
34023001100,0.9919476597886261,0.00805234021137393,1265,0,929,254,345,"Census Tract 11, Middlesex County, New Jersey",0,205,168,176,55,466,195,658,1313,1971,361,480,1722,31,57,2789,1987,16,841,88
34023001200,0.8603401969561325,0.1396598030438675,1207,0,1340,210,92,"Census Tract 12, Middlesex County, New Jersey",0,103,160,184,103,408,249,881,1041,1922,348,824,2682,75,93,2415,2234,312,1172,168
34023001300,0.9295392953929539,0.07046070460704607,1091,0,1144,163,249,"Census Tract 13, Middlesex County, New Jersey",0,105,110,132,157,295,292,838,877,1715,585,404,2330,78,77,2039,1845,130,989,155
34023001409,0.9658493870402802,0.03415061295971979,18,0,1034,49,244,"Census Tract 14.09, Middlesex County, New Jersey",0,0,0,0,8,10,0,1018,85,1103,514,520,2928,0,0,374,1142,39,1034,0
34023001410,0.9701789264413518,0.02982107355864811,306,0,1459,193,275,"Census Tract 14.10, Middlesex County, New Jersey",0,0,32,252,22,0,0,991,473,1464,445,924,2981,50,40,1155,1509,45,1369,90
34023001411,0.9592021758839528,0.04079782411604715,42,0,1162,26,279,"Census Tract 14.11, Middlesex County, New Jersey",0,17,0,0,0,11,14,1040,18,1058,554,608,3112,0,0,77,1103,45,1162,0
34023001412,0.9418212478920742,0.0581787521079258,67,0,907,23,205,"Census Tract 14.12, Middlesex County, New Jersey",0,0,0,9,0,58,0,1031,86,1117,568,339,2943,0,0,303,1186,69,907,0
34023001413,0.9613079019073569,0.038692098092643054,131,0,1417,18,401,"Census Tract 14.13, Middlesex County, New Jersey",0,15,51,0,27,18,20,1370,394,1764,1093,223,4010,101,0,1364,1835,71,1316,101
34023001414,0.9611984282907662,0.03880157170923379,787,0,1132,158,355,"Census Tract 14.14, Middlesex County, New Jersey",0,419,71,0,188,42,67,1218,739,1957,680,397,3112,55,0,2070,2036,79,1077,55
34023001415,0.956271576524741,0.04372842347525892,75,0,2121,46,467,"Census Tract 14.15, Middlesex County, New Jersey",0,0,0,0,0,0,75,1571,91,1662,995,987,4769,139,0,315,1738,76,1982,139
34023001416,0.9818752178459393,0.01812478215406065,2142,0,1078,331,937,"Census Tract 14.16, Middlesex County, New Jersey",0,611,325,111,793,195,107,577,2240,2817,326,338,1856,371,43,7308,2869,52,664,414
34023001417,0.9069462647444299,0.09305373525557012,196,0.002621231979030144,707,140,147,"Census Tract 14.17, Middlesex County, New Jersey",2,0,10,175,0,0,11,525,167,692,380,322,1708,5,0,220,763,71,702,5
34023001502,0.9667519181585678,0.03324808184143223,455,0,2076,53,295,"Census Tract 15.02, Middlesex County, New Jersey",0,115,66,0,9,58,207,1397,493,1890,794,1214,4837,42,26,1226,1955,65,2008,68
34023001504,0.9726027397260274,0.0273972602739726,1166,0,1091,45,497,"Census Tract 15.04, Middlesex County, New Jersey",0,504,134,48,367,86,27,936,1052,1988,427,642,2703,14,8,2954,2044,56,1069,22
34023001505,0.9171974522292994,0.08280254777070063,338,0,391,36,281,"Census Tract 15.05, Middlesex County, New Jersey",0,171,0,12,136,15,4,234,486,720,277,53,690,25,36,1486,785,65,330,61
34023001506,0.9167095115681234,0.0832904884318766,1552,0,330,75,589,"Census Tract 15.06, Middlesex County, New Jersey",0,763,52,132,522,34,49,261,1522,1783,29,96,809,190,15,4497,1945,162,125,205
34023001600,0.9751322751322752,0.02486772486772487,741,0.011111111111111112,1537,60,274,"Census Tract 16, Middlesex County, New Jersey",21,204,58,0,98,115,266,1237,606,1843,642,793,3719,43,59,1250,1890,47,1435,102
34023001701,0.9501936912008855,0.04980630879911455,45,0,2277,14,115,"Census Tract 17.01, Middlesex County, New Jersey",0,17,9,0,0,6,13,1575,142,1717,962,1306,4647,0,9,508,1807,90,2268,9
34023001702,0.9682170542635659,0.03178294573643411,401,0,1410,18,100,"Census Tract 17.02, Middlesex County, New Jersey",0,185,26,9,62,34,85,885,364,1249,556,653,2464,62,139,1092,1290,41,1209,201
34023001803,0.9755244755244755,0.024475524475524476,226,0,867,55,29,"Census Tract 18.03, Middlesex County, New Jersey",0,0,30,0,31,7,158,766,350,1116,317,515,2122,18,17,971,1144,28,832,35
34023001804,0.9944954128440368,0.005504587155963303,644,0.09418960244648318,1033,144,145,"Census Tract 18.04, Middlesex County, New Jersey",154,180,118,33,89,147,77,897,729,1626,449,491,2547,64,29,1672,1635,9,940,93
34023001805,0.9283938339134759,0.07160616608652412,1046,0,1224,69,223,"Census Tract 18.05, Middlesex County, New Jersey",0,350,176,151,215,45,109,985,882,1867,375,593,2866,256,0,2204,2011,144,968,256
34023001901,0.927289896128423,0.07271010387157696,1440,0,919,170,248,"Census Tract 19.01, Middlesex County, New Jersey",0,672,267,103,194,116,88,1023,941,1964,434,322,2658,62,101,1914,2118,154,756,163
34023001902,0.9919816723940436,0.008018327605956471,279,0,833,23,67,"Census Tract 19.02, Middlesex County, New Jersey",0,40,8,15,36,74,106,549,317,866,311,446,1536,46,30,641,873,7,757,76
34023001903,0.9487908961593172,0.051209103840682786,595,0,1188,183,279,"Census Tract 19.03, Middlesex County, New Jersey",0,20,17,195,93,172,98,724,610,1334,710,455,2287,23,0,1215,1406,72,1165,23
34023002000,0.936969696969697,0.06303030303030303,536,0,1487,64,438,"Census Tract 20, Middlesex County, New Jersey",0,53,46,110,99,76,152,1092,454,1546,550,820,2843,60,57,1165,1650,104,1370,117
34023002101,0.9384057971014492,0.06159420289855073,93,0,784,7,245,"Census Tract 21.01, Middlesex County, New Jersey",0,31,0,0,4,6,52,684,93,777,481,279,1988,0,24,200,828,51,760,24
34023002102,0.9931740614334471,0.006825938566552901,350,0,1367,32,466,"Census Tract 21.02, Middlesex County, New Jersey",0,16,43,54,72,106,59,1051,404,1455,562,761,2967,35,9,956,1465,10,1323,44
34023002200,0.9834368530020704,0.016563146997929608,249,0,1491,81,294,"Census Tract 22, Middlesex County, New Jersey",0,26,0,132,40,27,24,1217,208,1425,738,718,3295,35,0,439,1449,24,1456,35
34023002301,0.970193740685544,0.029806259314456036,11,0,1648,27,108,"Census Tract 23.01, Middlesex County, New Jersey",0,0,0,0,0,0,11,1232,70,1302,839,809,3750,0,0,110,1342,40,1648,0
34023002302,0.9434290687554395,0.05657093124456049,22,0,1614,46,94,"Census Tract 23.02, Middlesex County, New Jersey",0,0,0,0,0,0,22,1041,43,1084,830,724,3453,0,60,90,1149,65,1554,60
34023002401,0.9789251844046365,0.02107481559536354,88,0,2572,116,164,"Census Tract 24.01, Middlesex County, New Jersey",0,0,0,0,0,0,88,1674,184,1858,1065,1329,4926,146,32,509,1898,40,2394,178
34023002402,0.9577735124760077,0.04222648752399232,0,0,714,23,53,"Census Tract 24.02, Middlesex County, New Jersey",0,0,0,0,0,0,0,473,26,499,385,329,1504,0,0,112,521,22,714,0
34023002500,0.9772516248839369,0.02274837511606314,214,0,2648,151,577,"Census Tract 25, Middlesex County, New Jersey",0,0,0,46,60,11,97,1693,412,2105,1265,1197,5046,186,0,1553,2154,49,2462,186
34023002603,0.9636542239685658,0.036345776031434185,1199,0,1509,149,600,"Census Tract 26.03, Middlesex County, New Jersey",0,511,212,195,156,45,80,973,989,1962,817,636,2902,0,56,2204,2036,74,1453,56
34023002604,0.9508344609833108,0.04916553901668922,294,0,2931,103,330,"Census Tract 26.04, Middlesex County, New Jersey",0,152,58,0,77,0,7,1961,147,2108,1483,1416,5740,32,0,495,2217,109,2899,32
34023002605,0.9735883424408015,0.026411657559198543,407,0,1129,0,82,"Census Tract 26.05, Middlesex County, New Jersey",0,230,44,63,0,11,59,699,370,1069,649,299,1858,181,0,917,1098,29,948,181
34023002701,0.9726747241198108,0.027325275880189175,1139,0,1119,63,475,"Census Tract 27.01, Middlesex County, New Jersey",0,521,141,53,278,57,89,762,1089,1851,333,623,2640,81,82,3065,1903,52,956,163
34023002703,0.9055187637969095,0.09448123620309051,817,0,2030,246,92,"Census Tract 27.03, Middlesex County, New Jersey",0,122,60,202,131,57,245,1345,706,2051,979,968,3724,83,0,1769,2265,214,1947,83
34023002805,0.8913043478260869,0.10869565217391304,74,0,1184,43,109,"Census Tract 28.05, Middlesex County, New Jersey",0,0,0,0,15,15,44,735,126,861,424,713,2079,13,34,429,966,105,1137,47
34023002901,0.9482619240097009,0.05173807599029911,557,0,977,59,230,"Census Tract 29.01, Middlesex County, New Jersey",0,105,55,80,158,18,141,591,582,1173,262,694,1714,21,0,1684,1237,64,956,21
34023002902,1,0,541,0,623,256,222,"Census Tract 29.02, Middlesex County, New Jersey",0,23,142,162,34,14,166,570,636,1206,310,296,1653,0,17,1723,1206,0,606,17
34023003001,0.9104991394148021,0.08950086058519793,537,0.010327022375215147,1519,116,186,"Census Tract 30.01, Middlesex County, New Jersey",18,173,0,87,234,0,43,1128,459,1587,663,682,2967,174,0,1148,1743,156,1345,174
34023003002,0.9440066362505185,0.055993363749481544,1611,0,776,126,780,"Census Tract 30.02, Middlesex County, New Jersey",0,707,121,93,610,73,7,1090,1186,2276,244,337,2494,140,55,3609,2411,135,581,195
34023003101,0.9391812865497076,0.0608187134502924,43,0,1204,20,115,"Census Tract 31.01, Middlesex County, New Jersey",0,12,6,14,0,0,11,769,34,803,603,596,2425,0,5,127,855,52,1199,5
34023003102,0.9346368715083799,0.06536312849162011,821,0,1364,110,349,"Census Tract 31.02, Middlesex County, New Jersey",0,197,419,194,0,0,11,920,753,1673,530,742,2807,66,26,1862,1790,117,1272,92
34023003201,0.9412795793163892,0.058720420683610865,67,0,1293,20,34,"Census Tract 32.01, Middlesex County, New Jersey",0,0,0,0,0,25,42,1031,43,1074,662,586,2992,45,0,159,1141,67,1248,45
34023003203,0.9564891222805701,0.04351087771942986,353,0,1343,127,170,"Census Tract 32.03, Middlesex County, New Jersey",0,0,15,60,0,69,209,930,345,1275,721,555,2833,23,44,852,1333,58,1276,67
34023003300,0.9403341288782816,0.059665871121718374,1119,0,1389,163,64,"Census Tract 33, Middlesex County, New Jersey",0,270,127,76,93,125,428,1154,816,1970,525,649,3099,133,82,2343,2095,125,1174,215
34023003401,0.9408866995073891,0.059113300492610835,380,0,1358,75,84,"Census Tract 34.01, Middlesex County, New Jersey",0,30,45,6,15,45,239,988,349,1337,448,698,2704,185,27,910,1421,84,1146,212
34023003500,0.9023034154090548,0.0976965845909452,163,0.221604447974583,1083,78,144,"Census Tract 35, Middlesex County, New Jersey",279,0,0,0,0,72,91,915,221,1136,259,774,2715,42,8,599,1259,123,1033,50
34023003600,0.9553805774278216,0.04461942257217848,1765,0.0044994375703037125,1642,357,366,"Census Tract 36, Middlesex County, New Jersey",12,53,389,76,76,332,839,984,1564,2548,213,805,3415,594,30,3846,2667,119,1018,624
34023003700,0.9586260733801717,0.041373926619828257,350,0,1045,92,192,"Census Tract 37, Middlesex County, New Jersey",0,54,9,14,86,39,148,902,326,1228,428,569,2959,21,27,749,1281,53,997,48
34023003800,0.9191606467148263,0.08083935328517372,953,0.004471964224286206,2966,207,457,"Census Tract 38, Middlesex County, New Jersey",13,334,129,96,34,107,253,1721,951,2672,1388,1436,5793,117,25,2545,2907,235,2824,142
34023004000,0.9486842105263158,0.05131578947368421,807,0,956,49,69,"Census Tract 40, Middlesex County, New Jersey",0,380,182,18,130,33,64,606,836,1442,381,422,1830,153,0,2017,1520,78,803,153
34023004100,0.8650875386199794,0.1349124613800206,355,0,780,141,72,"Census Tract 41, Middlesex County, New Jersey",0,0,0,92,6,70,187,555,285,840,460,314,1818,0,6,748,971,131,774,6
34023004200,0.8805147058823529,0.11948529411764706,518,0,748,143,41,"Census Tract 42, Middlesex County, New Jersey",0,0,0,0,11,113,394,450,508,958,299,293,1392,126,30,1688,1088,130,592,156
34023004300,0.8748957464553795,0.12510425354462051,434,0.025020850708924104,860,124,49,"Census Tract 43, Middlesex County, New Jersey",30,5,25,0,0,65,339,479,570,1049,191,370,1957,272,27,1971,1199,150,561,299
34023004400,0.9737609329446064,0.026239067055393587,780,0,640,247,49,"Census Tract 44, Middlesex County, New Jersey",0,7,0,0,8,35,730,393,943,1336,201,277,1362,122,40,3327,1372,36,478,162
34023004500,0.9725854070012653,0.02741459299873471,1703,0,916,511,240,"Census Tract 45, Middlesex County, New Jersey",0,533,126,86,41,217,700,457,1849,2306,547,175,1997,194,0,6306,2371,65,722,194
34023004600,0.9548913043478261,0.045108695652173916,1371,0,877,526,134,"Census Tract 46, Middlesex County, New Jersey",0,115,92,144,256,250,514,331,1426,1757,162,91,920,470,154,4531,1840,83,253,624
34023004700,0.927098674521355,0.07290132547864507,942,0,526,217,110,"Census Tract 47, Middlesex County, New Jersey",0,148,54,24,161,204,351,350,909,1259,120,93,1303,183,130,2899,1358,99,213,313
34023004800,0.9492502883506344,0.05074971164936563,1406,0,783,431,68,"Census Tract 48, Middlesex County, New Jersey",0,98,56,180,37,283,752,246,1400,1646,194,220,944,209,160,4234,1734,88,414,369
34023004900,0.9840534979423868,0.01594650205761317,1684,0,547,690,100,"Census Tract 49, Middlesex County, New Jersey",0,186,354,386,198,115,445,287,1626,1913,111,207,708,38,191,4157,1944,31,318,229
34023005000,0.9177820267686424,0.08221797323135756,966,0,785,256,83,"Census Tract 50, Middlesex County, New Jersey",0,0,50,21,61,330,504,519,921,1440,337,258,1733,170,20,3362,1569,129,595,190
34023005100,0.8402994385527136,0.15970056144728634,1243,0,463,172,209,"Census Tract 51, Middlesex County, New Jersey",0,117,165,623,24,105,209,182,1165,1347,71,129,408,214,49,2715,1603,256,200,263
34023005200,0.8547655068078669,0.14523449319213314,1208,0,169,513,251,"Census Tract 52, Middlesex County, New Jersey",0,56,90,411,120,80,451,71,1624,1695,30,73,115,22,44,5166,1983,288,103,66
34023005300,0.8940886699507389,0.10591133004926108,512,0,205,321,92,"Census Tract 53, Middlesex County, New Jersey",0,12,12,11,37,84,356,144,582,726,25,60,522,117,3,2635,812,86,85,120
34023005500,0.93125,0.06875,869,0,205,299,238,"Census Tract 55, Middlesex County, New Jersey",0,104,60,22,467,140,76,322,870,1192,181,24,1042,0,0,2767,1280,88,205,0
34023005601,0.9609292502639916,0.03907074973600845,644,0,434,283,10,"Census Tract 56.01, Middlesex County, New Jersey",0,52,87,42,72,143,248,162,748,910,143,27,604,264,0,2236,947,37,170,264
34023005602,0.9277958740499457,0.0722041259500543,1066,0,399,738,318,"Census Tract 56.02, Middlesex County, New Jersey",0,21,57,20,65,239,664,361,1348,1709,167,162,1620,26,44,6052,1842,133,329,70
34023005700,0.9781512605042016,0.021848739495798318,1092,0,596,412,123,"Census Tract 57, Middlesex County, New Jersey",0,99,132,260,159,236,206,504,1242,1746,211,385,1703,0,0,3543,1785,39,596,0
34023005800,0.8573224387177876,0.14267756128221246,805,0,600,452,190,"Census Tract 58, Middlesex County, New Jersey",0,42,0,42,59,150,512,211,1153,1364,219,198,584,109,74,4787,1591,227,417,183
34023006001,0.9581447963800905,0.0418552036199095,455,0,439,10,95,"Census Tract 60.01, Middlesex County, New Jersey",0,238,85,80,30,11,11,381,466,847,147,264,1076,0,28,1185,884,37,411,28
34023006002,0.9332273449920508,0.06677265500794913,1082,0,153,248,101,"Census Tract 60.02, Middlesex County, New Jersey",0,361,130,125,254,184,28,69,1105,1174,4,68,125,35,46,3009,1258,84,72,81
34023006101,0.9031645569620254,0.09683544303797469,684,0,642,232,96,"Census Tract 61.01, Middlesex County, New Jersey",0,0,35,241,8,76,324,673,754,1427,337,127,2480,126,52,2460,1580,153,464,178
34023006103,0.9457572502685284,0.054242749731471536,1126,0,1044,114,91,"Census Tract 61.03, Middlesex County, New Jersey",0,221,99,74,83,350,299,848,913,1761,388,571,2721,63,22,2378,1862,101,959,85
34023006104,0.948252688172043,0.05174731182795699,408,0,1114,87,186,"Census Tract 61.04, Middlesex County, New Jersey",0,204,20,14,78,46,46,1027,384,1411,527,544,3092,32,11,872,1488,77,1071,43
34023006203,0.9730316181029138,0.026968381897086176,1486,0.1097334159950403,1441,90,528,"Census Tract 62.03, Middlesex County, New Jersey",354,498,275,99,310,278,26,1572,1567,3139,955,362,4584,124,0,4185,3226,87,1317,124
34023006204,0.9665738161559888,0.033426183844011144,328,0,383,6,109,"Census Tract 62.04, Middlesex County, New Jersey",0,103,79,32,92,22,0,337,357,694,186,164,891,33,0,902,718,24,350,33
34023006205,0.9230218403150734,0.0769781596849266,976,0.008592910848549946,1838,55,445,"Census Tract 62.05, Middlesex County, New Jersey",24,435,17,13,432,79,0,1781,797,2578,1087,683,4986,0,68,1763,2793,215,1770,68
34023006206,0.9934426229508196,0.006557377049180328,6,0,773,7,61,"Census Tract 62.06, Middlesex County, New Jersey",0,0,0,0,0,0,6,575,31,606,315,452,1641,6,0,58,610,4,767,6
34023006207,1,0,1111,0.004178854993731718,1339,125,128,"Census Tract 62.07, Middlesex County, New Jersey",10,383,89,104,124,268,143,1062,1331,2393,385,639,3191,190,125,3328,2393,0,1024,315
34023006300,0.9086859688195991,0.09131403118040089,323,0,3015,51,135,"Census Tract 63, Middlesex County, New Jersey",0,0,22,0,0,151,150,2077,371,2448,1467,1437,5956,28,83,1031,2694,246,2904,111
34023006403,0.9854260089686099,0.014573991031390135,14,0,1151,10,202,"Census Tract 64.03, Middlesex County, New Jersey",0,0,0,0,0,0,14,868,11,879,614,537,2786,0,0,52,892,13,1151,0
34023006500,0.9698492462311558,0.03015075376884422,55,0,2838,37,281,"Census Tract 65, Middlesex County, New Jersey",0,26,0,16,13,0,0,2112,204,2316,1262,1576,6539,0,0,570,2388,72,2838,0
34023006601,0.9556354916067147,0.04436450839328537,23,0,1121,8,101,"Census Tract 66.01, Middlesex County, New Jersey",0,0,0,0,0,23,0,737,60,797,622,487,2310,0,12,197,834,37,1109,12
34023006604,0.9554208273894437,0.04457917261055635,1191,0,1871,218,339,"Census Tract 66.04, Middlesex County, New Jersey",0,301,50,429,301,57,53,1835,844,2679,986,641,4727,153,91,1899,2804,125,1627,244
34023006605,0.9785575048732943,0.021442495126705652,573,0,1032,153,256,"Census Tract 66.05, Middlesex County, New Jersey",0,185,120,226,31,0,11,899,607,1506,630,311,2927,48,43,879,1539,33,941,91
34023006606,0.933058702368692,0.06694129763130793,0,0,987,5,274,"Census Tract 66.06, Middlesex County, New Jersey",0,0,0,0,0,0,0,889,17,906,509,478,2895,0,0,56,971,65,987,0
34023006607,0.9832985386221295,0.016701461377870562,5,0,1552,16,180,"Census Tract 66.07, Middlesex County, New Jersey",0,0,5,0,0,0,0,937,5,942,848,704,2827,0,0,20,958,16,1552,0
34023006608,0.9706070287539936,0.02939297124600639,293,0.008306709265175719,1235,78,132,"Census Tract 66.08, Middlesex County, New Jersey",13,155,10,0,85,39,4,1291,228,1519,449,751,3214,0,35,487,1565,46,1200,35
34023006701,0.9672131147540983,0.03278688524590164,18,0,1581,77,239,"Census Tract 67.01, Middlesex County, New Jersey",0,0,11,0,0,7,0,1203,95,1298,682,899,3331,0,0,346,1342,44,1581,0
34023006703,0.9667178699436764,0.033282130056323606,89,0,2411,40,331,"Census Tract 67.03, Middlesex County, New Jersey",0,9,0,0,0,53,27,1623,265,1888,1173,1051,5049,15,172,1082,1953,65,2224,187
34023006800,0.9288116591928252,0.07118834080717489,297,0.005605381165919282,1919,78,82,"Census Tract 68, Middlesex County, New Jersey",10,19,0,0,18,40,220,1192,465,1657,1103,723,3259,65,28,1686,1784,127,1826,93
34023006900,0.8328173374613003,0.16718266253869968,689,0,529,212,95,"Census Tract 69, Middlesex County, New Jersey",0,23,92,0,12,135,427,531,545,1076,359,157,1435,0,13,1813,1292,216,516,13
34023007000,0.9678184281842819,0.03218157181571816,891,0,2556,403,392,"Census Tract 70, Middlesex County, New Jersey",0,191,31,208,80,179,202,1798,1059,2857,932,1490,5438,32,102,2444,2952,95,2422,134
34023007101,0.9451263537906137,0.054873646209386284,117,0,1346,30,197,"Census Tract 71.01, Middlesex County, New Jersey",0,0,0,0,36,10,71,1032,277,1309,716,557,2724,63,10,792,1385,76,1273,73
34023007102,0.9603658536585366,0.039634146341463415,239,0,1493,84,228,"Census Tract 71.02, Middlesex County, New Jersey",0,0,0,24,26,85,104,1146,429,1575,705,741,3772,8,39,925,1640,65,1446,47
34023007103,0.9593169261677549,0.040683073832245106,1898,0,500,83,61,"Census Tract 71.03, Middlesex County, New Jersey",0,1293,174,25,265,59,82,59,1851,1910,166,4,299,21,309,5055,1991,81,170,330
34023007202,0.9688601645123385,0.031139835487661575,107,0,2194,110,241,"Census Tract 72.02, Middlesex County, New Jersey",0,0,0,0,44,42,21,1478,171,1649,1162,1032,4249,0,0,453,1702,53,2194,0
34023007203,0.9712493465760585,0.028750653423941452,881,0,1282,204,213,"Census Tract 72.03, Middlesex County, New Jersey",0,291,126,148,201,83,32,1065,793,1858,455,766,3272,61,0,1728,1913,55,1221,61
34023007301,0.8934859154929577,0.10651408450704225,54,0,1432,8,153,"Census Tract 73.01, Middlesex County, New Jersey",0,54,0,0,0,0,0,919,96,1015,790,631,2861,11,0,186,1136,121,1421,11
34023007303,0.9484375,0.0515625,32,0.04375,758,9,82,"Census Tract 73.03, Middlesex County, New Jersey",28,0,0,0,0,0,32,572,35,607,383,370,1788,0,5,58,640,33,753,5
34023007304,0.9505843071786311,0.04941569282136895,1530,0,1518,175,572,"Census Tract 73.04, Middlesex County, New Jersey",0,239,657,42,225,260,107,1359,1488,2847,607,619,3584,180,112,3321,2995,148,1226,292
34023007402,0.9324186991869918,0.06758130081300813,458,0,1671,72,95,"Census Tract 74.02, Middlesex County, New Jersey",0,151,18,31,143,51,64,1488,347,1835,816,836,3369,8,11,901,1968,133,1652,19
34023007500,0.8528550512445096,0.14714494875549047,430,0,1197,63,137,"Census Tract 75, Middlesex County, New Jersey",0,0,16,0,51,132,231,834,331,1165,507,618,2312,0,72,813,1366,201,1125,72
34023007600,0.9562607204116638,0.04373927958833619,895,0,1294,261,153,"Census Tract 76, Middlesex County, New Jersey",0,44,105,206,70,172,298,1215,1015,2230,430,669,3348,107,88,2207,2332,102,1099,195
34023007702,0.9472517730496454,0.05274822695035461,975,0,653,61,454,"Census Tract 77.02, Middlesex County, New Jersey",0,163,55,63,269,346,79,1047,1090,2137,497,115,3326,27,14,2465,2256,119,612,41
34023007703,0.9780509218612818,0.021949078138718173,74,0.00877963125548727,1366,47,186,"Census Tract 77.03, Middlesex County, New Jersey",10,22,0,0,28,11,13,970,144,1114,884,455,3054,27,0,376,1139,25,1339,27
34023007704,0.9702868852459017,0.02971311475409836,124,0,1139,58,53,"Census Tract 77.04, Middlesex County, New Jersey",0,0,4,120,0,0,0,804,143,947,613,522,2521,4,0,225,976,29,1135,4
34023007801,0.9829867674858223,0.017013232514177693,1256,0,506,112,284,"Census Tract 78.01, Middlesex County, New Jersey",0,211,58,32,76,862,17,312,1248,1560,246,121,922,55,84,2373,1587,27,367,139
34023007804,0.9103521878335112,0.08964781216648879,240,0,2053,81,226,"Census Tract 78.04, Middlesex County, New Jersey",0,0,15,91,34,71,29,1455,251,1706,884,1169,4404,0,0,555,1874,168,2053,0
34023007805,0.9648774022531478,0.03512259774685222,24,0,2024,18,178,"Census Tract 78.05, Middlesex County, New Jersey",0,0,0,0,0,24,0,1432,24,1456,651,1373,4623,0,0,56,1509,53,2024,0
34023007806,0.9661898569570871,0.033810143042912875,482,0,1905,94,250,"Census Tract 78.06, Middlesex County, New Jersey",0,220,32,30,123,60,17,917,569,1486,946,754,3001,130,75,1040,1538,52,1700,205
34023007905,0.9805352798053528,0.019464720194647202,0,0,1144,5,126,"Census Tract 79.05, Middlesex County, New Jersey",0,0,0,0,0,0,0,706,100,806,450,694,2037,0,0,202,822,16,1144,0
34023007906,0.9526226734348562,0.047377326565143825,395,0,444,48,109,"Census Tract 79.06, Middlesex County, New Jersey",0,218,37,14,38,61,27,186,377,563,179,154,629,97,14,878,591,28,333,111
34023007907,1,0,631,0,1009,54,350,"Census Tract 79.07, Middlesex County, New Jersey",0,294,91,41,69,106,30,745,643,1388,534,408,2077,56,11,1123,1388,0,942,67
34023007908,0.9144641999038924,0.08553580009610764,2048,0,735,124,200,"Census Tract 79.08, Middlesex County, New Jersey",0,810,613,34,177,254,160,10,1893,1903,25,0,25,527,183,4672,2081,178,25,710
34023007909,0.9708939708939709,0.029106029106029108,60,0,1447,14,336,"Census Tract 79.09, Middlesex County, New Jersey",0,0,0,23,24,0,13,1288,113,1401,831,616,4031,0,0,300,1443,42,1447,0
34023007910,0.9155023286759814,0.08449767132401863,529,0,1291,174,156,"Census Tract 79.10, Middlesex County, New Jersey",0,44,0,0,50,341,94,1220,156,1376,905,386,2752,0,0,302,1503,127,1291,0
34023007911,0.9617391304347827,0.03826086956521739,61,0,1447,0,208,"Census Tract 79.11, Middlesex County, New Jersey",0,27,0,0,0,34,0,1023,83,1106,1153,61,3313,233,0,302,1150,44,1214,233
34023007912,0.9367704280155642,0.0632295719844358,847,0.00648508430609598,2026,133,762,"Census Tract 79.12, Middlesex County, New Jersey",20,137,373,157,88,92,0,2403,486,2889,1153,844,6072,23,6,953,3084,195,1997,29
34023008001,0.8846013833272661,0.11539861667273389,467,0,2178,104,263,"Census Tract 80.01, Middlesex County, New Jersey",0,97,28,54,136,15,137,1622,808,2430,1137,989,4878,28,24,2020,2747,317,2126,52
34023008101,0.941234084231146,0.058765915768854066,442,0.16503428011753182,1358,163,29,"Census Tract 81.01, Middlesex County, New Jersey",337,82,72,21,21,122,124,1462,460,1922,659,699,3617,0,0,806,2042,120,1358,0
34023008102,1,0,262,0,1729,126,121,"Census Tract 81.02, Middlesex County, New Jersey",0,0,0,262,0,0,0,1149,268,1417,754,962,3533,13,0,324,1417,0,1716,13
34023008103,0.8995943204868154,0.10040567951318459,389,0,677,32,53,"Census Tract 81.03, Middlesex County, New Jersey",0,281,7,0,63,21,17,710,177,887,400,277,1773,0,0,510,986,99,677,0
34023008202,0.9595057034220532,0.040494296577946766,324,0,1422,212,721,"Census Tract 82.02, Middlesex County, New Jersey",0,89,11,150,0,65,9,4679,368,5047,716,668,13015,0,38,805,5260,213,1384,38
34023008204,0.981301421091997,0.018698578908002993,163,0,766,155,123,"Census Tract 82.04, Middlesex County, New Jersey",0,0,0,0,46,55,62,2348,276,2624,420,331,3940,15,0,516,2674,50,751,15
34023008205,0.9683571738188123,0.03164282618118769,608,0,972,214,18,"Census Tract 82.05, Middlesex County, New Jersey",0,0,0,34,86,334,154,2013,221,2234,610,280,3093,22,60,284,2307,73,890,82
34023008206,0.924202626641651,0.07579737335834896,1116,0,633,642,29,"Census Tract 82.06, Middlesex County, New Jersey",0,43,28,388,53,305,299,1835,628,2463,345,275,2645,13,0,913,2665,202,620,13
34023008207,0.9640333975594091,0.03596660244059088,130,0,975,83,49,"Census Tract 82.07, Middlesex County, New Jersey",0,23,0,0,80,17,10,1413,88,1501,713,236,2483,26,0,179,1557,56,949,26
34023008208,0.9910913140311804,0.008908685968819599,134,0,3538,165,353,"Census Tract 82.08, Middlesex County, New Jersey",0,0,0,134,0,0,0,3343,217,3560,2307,882,11506,177,172,483,3592,32,3189,349
34023008209,0.9645799011532126,0.03542009884678748,0,0,1675,10,102,"Census Tract 82.09, Middlesex County, New Jersey",0,0,0,0,0,0,0,1155,16,1171,770,905,3454,0,0,55,1214,43,1675,0
34023008300,0.9221854304635762,0.07781456953642384,775,0,1502,109,240,"Census Tract 83, Middlesex County, New Jersey",0,105,102,0,109,278,181,1458,770,2228,1002,446,4050,54,0,1879,2416,188,1448,54
34023008403,0.967982924226254,0.032017075773746,405,0.017075773745997867,1654,61,595,"Census Tract 84.03, Middlesex County, New Jersey",48,238,12,0,25,27,103,2253,468,2721,1052,505,6277,74,23,1269,2811,90,1557,97
34023008404,0.9700187382885697,0.029981261711430358,292,0.10306058713304185,1656,135,126,"Census Tract 84.04, Middlesex County, New Jersey",165,185,0,29,54,24,0,1205,348,1553,752,682,3359,46,176,636,1601,48,1434,222
34023008405,0.9462835727670206,0.05371642723297939,30,0,1961,11,311,"Census Tract 84.05, Middlesex County, New Jersey",0,0,9,0,12,9,0,1477,38,1515,1380,554,4759,27,0,118,1601,86,1934,27
34023008406,0.9725651577503429,0.027434842249657063,0,0.0877914951989026,911,31,103,"Census Tract 84.06, Middlesex County, New Jersey",64,0,0,0,0,0,0,666,43,709,442,469,2047,0,0,129,729,20,911,0
34023008501,0.9566315789473684,0.04336842105263158,1515,0.053052631578947365,511,98,110,"Census Tract 85.01, Middlesex County, New Jersey",126,515,379,79,315,129,98,654,1618,2272,292,189,1686,30,0,4124,2375,103,481,30
34023008502,0.9472490073737947,0.052750992626205334,57,0,1380,30,314,"Census Tract 85.02, Middlesex County, New Jersey",0,0,0,0,47,0,10,1548,122,1670,755,552,4819,13,60,292,1763,93,1307,73
34023008503,0.9511126095751854,0.04888739042481457,593,0,2131,82,383,"Census Tract 85.03, Middlesex County, New Jersey",0,241,0,37,139,141,35,2242,579,2821,1379,671,6908,81,0,2061,2966,145,2050,81
34023008504,0.9462599854756718,0.05374001452432825,1007,0,1683,128,293,"Census Tract 85.04, Middlesex County, New Jersey",0,303,13,234,263,164,30,2086,520,2606,1035,549,5826,82,17,873,2754,148,1584,99
34023008601,0.923217550274223,0.07678244972577697,624,0,1092,87,393,"Census Tract 86.01, Middlesex County, New Jersey",0,113,59,288,60,83,21,1652,368,2020,676,416,4301,0,0,713,2188,168,1092,0
34023008602,0.948111060537096,0.05188893946290396,1414,0,1018,38,299,"Census Tract 86.02, Middlesex County, New Jersey",0,778,115,13,362,121,25,932,1151,2083,778,192,2520,48,0,2730,2197,114,970,48
34023008604,0.852595680181887,0.14740431981811292,1603,0,795,70,327,"Census Tract 86.04, Middlesex County, New Jersey",0,220,74,172,797,322,18,1217,1033,2250,581,97,3582,49,68,2368,2639,389,678,117
34023008605,0.9732528041415013,0.026747195858498704,870,0,303,53,185,"Census Tract 86.05, Middlesex County, New Jersey",0,275,82,113,334,59,7,471,657,1128,276,27,1343,0,0,1253,1159,31,303,0
34023008606,0.7846763540290621,0.21532364597093792,1999,0,309,61,294,"Census Tract 86.06, Middlesex County, New Jersey",0,655,184,176,661,261,62,195,1587,1782,139,0,598,170,0,3556,2271,489,139,170
34023008700,0.9617258176757133,0.038274182324286705,122,0,1377,20,202,"Census Tract 87, Middlesex County, New Jersey",0,0,9,0,30,32,51,1178,204,1382,766,531,3303,0,80,435,1437,55,1297,80
34023008800,0.7992424242424242,0.20075757575757575,255,0,551,32,86,"Census Tract 88, Middlesex County, New Jersey",0,25,55,19,128,14,14,462,171,633,301,250,1433,0,0,561,792,159,551,0
34023008900,0.9753363228699552,0.02466367713004484,1628,0,310,57,210,"Census Tract 89, Middlesex County, New Jersey",0,569,271,95,530,88,75,370,1370,1740,124,44,1043,86,56,3038,1784,44,168,142
34023009000,0.9564879564879565,0.04351204351204351,676,0.2540792540792541,607,95,190,"Census Tract 90, Middlesex County, New Jersey",327,281,51,91,154,74,25,439,792,1231,106,280,1015,221,0,2288,1287,56,386,221
34023009100,0.895924308588064,0.10407569141193596,426,0,1089,53,85,"Census Tract 91, Middlesex County, New Jersey",0,106,95,22,58,0,145,815,416,1231,485,591,2366,0,13,1266,1374,143,1076,13
34023009200,0.9951742627345844,0.00482573726541555,326,0.00804289544235925,1593,117,231,"Census Tract 92, Middlesex County, New Jersey",15,14,40,118,18,45,91,1337,519,1856,709,667,3386,217,0,1466,1865,9,1376,217
34023009300,0.9214858590122414,0.07851414098775855,2061,0,315,643,309,"Census Tract 93, Middlesex County, New Jersey",0,179,285,1117,86,266,128,150,2033,2183,30,0,197,267,18,5195,2369,186,30,285
34023009400,0.8922254216371863,0.10777457836281365,1417,0.00658165364047717,1484,147,196,"Census Tract 94, Middlesex County, New Jersey",16,583,207,133,218,147,129,1334,835,2169,413,874,3500,121,76,2054,2431,262,1287,197
34025800100,0.7748123436196831,0.22518765638031693,1633,0.06227411731998888,1330,204,438,"Census Tract 8001, Monmouth County, New Jersey",224,551,155,390,158,298,81,1715,1072,2787,629,591,3066,110,0,1752,3597,810,1220,110
34025800200,0.8851699279093718,0.11483007209062822,464,0,1781,99,231,"Census Tract 8002, Monmouth County, New Jersey",0,39,95,118,19,46,147,1328,391,1719,890,873,3603,18,0,681,1942,223,1763,18
34025800400,0.962043795620438,0.03795620437956204,73,0,1330,110,129,"Census Tract 8004, Monmouth County, New Jersey",0,0,0,0,0,0,73,1152,166,1318,472,843,3170,9,6,362,1370,52,1315,15
34025800500,0.9360354654844838,0.06396453451551615,183,0,1692,36,289,"Census Tract 8005, Monmouth County, New Jersey",0,29,11,0,0,42,101,1232,246,1478,727,904,3828,0,61,547,1579,101,1631,61
34025800601,0.9083166332665331,0.09168336673346693,415,0,1688,43,223,"Census Tract 8006.01, Monmouth County, New Jersey",0,9,0,135,32,51,188,1192,621,1813,797,861,3416,19,11,1752,1996,183,1658,30
34025800602,0.9291666666666667,0.07083333333333333,13,0.015,1887,16,114,"Census Tract 8006.02, Monmouth County, New Jersey",18,0,0,0,0,0,13,1052,63,1115,979,908,3150,0,0,145,1200,85,1887,0
34025800701,0.9771908763505402,0.022809123649459785,67,0,2416,53,262,"Census Tract 8007.01, Monmouth County, New Jersey",0,0,0,0,36,0,31,1548,80,1628,1421,988,4707,7,0,366,1666,38,2409,7
34025800702,1,0,311,0,1345,129,207,"Census Tract 8007.02, Monmouth County, New Jersey",0,0,21,263,27,0,0,957,355,1312,795,531,3099,10,9,620,1312,0,1326,19
34025800800,0.9834926151172894,0.016507384882710686,484,0,2337,31,327,"Census Tract 8008, Monmouth County, New Jersey",0,114,0,122,122,93,33,1649,615,2264,806,1467,4481,64,0,1788,2302,38,2273,64
34025800900,0.9348430671434247,0.06515693285657528,482,0,2390,117,392,"Census Tract 8009, Monmouth County, New Jersey",0,151,46,255,0,16,14,1769,584,2353,1335,917,4716,35,103,833,2517,164,2252,138
34025801000,0.9600704638872578,0.03992953611274222,537,0,1508,234,370,"Census Tract 8010, Monmouth County, New Jersey",0,243,9,162,56,20,47,1074,561,1635,738,684,3101,86,0,1109,1703,68,1422,86
34025801100,0.930841121495327,0.0691588785046729,146,0,1574,60,317,"Census Tract 8011, Monmouth County, New Jersey",0,0,13,93,40,0,0,1362,132,1494,888,686,3887,0,0,315,1605,111,1574,0
34025801200,0.9933774834437086,0.006622516556291391,9,0,1588,7,365,"Census Tract 8012, Monmouth County, New Jersey",0,9,0,0,0,0,0,1191,9,1200,778,810,3656,0,0,36,1208,8,1588,0
34025801300,0.9701986754966887,0.029801324503311258,651,0,2177,226,355,"Census Tract 8013, Monmouth County, New Jersey",0,236,17,20,172,192,14,2437,200,2637,1323,854,5519,0,0,362,2718,81,2177,0
34025801400,0.9678571428571429,0.03214285714285714,0,0,1966,18,243,"Census Tract 8014, Monmouth County, New Jersey",0,0,0,0,0,0,0,1289,66,1355,923,1020,3840,0,23,192,1400,45,1943,23
34025801500,0.9478221415607986,0.052177858439201454,250,0,2160,96,329,"Census Tract 8015, Monmouth County, New Jersey",0,0,0,213,0,37,0,1861,228,2089,1007,1128,6007,25,0,286,2204,115,2135,25
34025801600,0.8614948636202622,0.13850513637973788,922,0,1620,437,333,"Census Tract 8016, Monmouth County, New Jersey",0,67,90,392,81,52,240,1418,1014,2432,763,797,3556,60,0,1973,2823,391,1560,60
34025801700,0.725909090909091,0.2740909090909091,784,0.011363636363636364,1042,255,172,"Census Tract 8017, Monmouth County, New Jersey",25,157,20,45,99,186,277,709,888,1597,453,520,2020,30,39,2073,2200,603,973,69
34025801800,0.8573369565217391,0.14266304347826086,108,0,2332,68,160,"Census Tract 8018, Monmouth County, New Jersey",0,0,0,0,0,0,108,1757,136,1893,1017,1315,5044,0,0,499,2208,315,2332,0
34025801900,0.9089026915113871,0.09109730848861283,520,0,744,78,95,"Census Tract 8019, Monmouth County, New Jersey",0,59,68,106,54,39,194,766,551,1317,307,325,1856,106,6,1414,1449,132,632,112
34025802000,0.9655367231638418,0.03446327683615819,871,0,864,478,126,"Census Tract 8020, Monmouth County, New Jersey",0,100,14,537,23,10,187,741,968,1709,348,394,1777,93,29,1983,1770,61,742,122
34025802100,0.9397485912440399,0.06025140875596012,255,0.09189423493714781,3062,149,307,"Census Tract 8021, Monmouth County, New Jersey",212,40,0,26,80,87,22,1766,402,2168,1476,1404,5524,141,41,690,2307,139,2880,182
34025802200,0.9174311926605505,0.08256880733944955,20,0.1874180865006553,1731,44,157,"Census Tract 8022, Monmouth County, New Jersey",286,0,0,0,0,0,20,1279,121,1400,737,906,3403,77,11,365,1526,126,1643,88
34025802300,0.9527607361963191,0.04723926380368098,102,0.08220858895705521,1924,114,168,"Census Tract 8023, Monmouth County, New Jersey",134,0,0,89,0,0,13,1325,228,1553,937,937,3945,38,12,412,1630,77,1874,50
34025802400,0.983094262295082,0.016905737704918034,107,0,2534,30,327,"Census Tract 8024, Monmouth County, New Jersey",0,15,0,0,84,0,8,1782,137,1919,1116,1418,5077,0,0,331,1952,33,2534,0
34025802500,0.9324104234527687,0.06758957654723127,20,0,1496,85,115,"Census Tract 8025, Monmouth County, New Jersey",0,10,0,0,0,0,10,1039,106,1145,636,847,2679,0,13,322,1228,83,1483,13
34025802600,0.914074074074074,0.08592592592592592,980,0,1064,65,243,"Census Tract 8026, Monmouth County, New Jersey",0,242,40,105,89,415,89,1006,845,1851,429,580,2843,38,17,1703,2025,174,1009,55
34025802700,0.9733250620347395,0.026674937965260544,334,0,1377,52,345,"Census Tract 8027, Monmouth County, New Jersey",0,46,101,172,0,3,12,1188,381,1569,891,486,3151,0,0,888,1612,43,1377,0
34025802800,0.9779688339602365,0.02203116603976357,478,0,1730,101,364,"Census Tract 8028, Monmouth County, New Jersey",0,223,0,12,141,32,70,1512,308,1820,1109,584,4087,23,14,601,1861,41,1693,37
34025802900,0.9315245478036176,0.06847545219638243,86,0,765,13,131,"Census Tract 8029, Monmouth County, New Jersey",0,25,12,0,15,28,6,631,90,721,447,318,1748,0,0,217,774,53,765,0
34025803000,0.9825718323127649,0.017428167687235045,769,0,1440,82,479,"Census Tract 8030, Monmouth County, New Jersey",0,235,78,106,129,195,26,1453,633,2086,692,716,4162,24,8,1193,2123,37,1408,32
34025803100,0.9483002832861189,0.051699716713881017,564,0,1073,19,150,"Census Tract 8031, Monmouth County, New Jersey",0,174,41,119,93,104,33,780,559,1339,419,595,2153,40,19,1220,1412,73,1014,59
34025803201,0.9342417061611374,0.06575829383886256,226,0.017772511848341232,879,57,170,"Census Tract 8032.01, Monmouth County, New Jersey",30,62,0,0,70,85,9,1205,372,1577,509,305,2991,65,0,811,1688,111,814,65
34025803202,0.9569202566452796,0.04307974335472044,265,0,1780,60,609,"Census Tract 8032.02, Monmouth County, New Jersey",0,30,0,235,0,0,0,1771,317,2088,1100,661,5503,0,19,476,2182,94,1761,19
34025803300,0.9560283687943263,0.04397163120567376,11,0,2716,0,408,"Census Tract 8033, Monmouth County, New Jersey",0,0,0,0,11,0,0,1907,115,2022,1364,1352,6082,0,0,284,2115,93,2716,0
34025803400,0.9200236966824644,0.07997630331753554,690,0,642,474,129,"Census Tract 8034, Monmouth County, New Jersey",0,27,46,65,92,187,273,552,1001,1553,187,369,1391,78,8,3547,1688,135,556,86
34025803500,0.9376899696048632,0.06231003039513678,673,0,589,130,124,"Census Tract 8035, Monmouth County, New Jersey",0,125,124,131,77,137,79,646,588,1234,345,193,1401,43,8,1152,1316,82,538,51
34025803600,0.8990439770554494,0.10095602294455067,1424,0,888,141,201,"Census Tract 8036, Monmouth County, New Jersey",0,106,92,567,86,332,241,1272,1079,2351,327,380,2531,61,120,1925,2615,264,707,181
34025803700,0.966804979253112,0.03319502074688797,27,0.00466804979253112,1686,10,616,"Census Tract 8037, Monmouth County, New Jersey",9,0,0,0,0,0,27,1682,182,1864,819,787,5284,0,80,654,1928,64,1606,80
34025803800,0.9000908265213442,0.09990917347865577,0,0,870,45,409,"Census Tract 8038, Monmouth County, New Jersey",0,0,0,0,0,0,0,934,57,991,591,269,2987,10,0,146,1101,110,860,10
34025803900,0.8954887218045112,0.10451127819548872,53,0,1104,7,391,"Census Tract 8039, Monmouth County, New Jersey",0,0,0,0,0,0,53,1072,119,1191,659,433,3372,12,0,281,1330,139,1092,12
34025804100,0.7250894225855902,0.27491057741440983,853,0,931,24,200,"Census Tract 8041, Monmouth County, New Jersey",0,20,54,542,176,19,42,1212,207,1419,566,358,2813,7,0,408,1957,538,924,7
34025804200,0.9540909090909091,0.045909090909090906,69,0.02,1856,0,417,"Census Tract 8042, Monmouth County, New Jersey",44,0,12,0,41,16,0,1942,157,2099,1035,731,5498,0,90,366,2200,101,1766,90
34025804500,0.9249665029030817,0.07503349709691827,335,0,1866,177,92,"Census Tract 8045, Monmouth County, New Jersey",0,64,3,144,109,15,0,1770,301,2071,1007,774,4463,70,15,638,2239,168,1781,85
34025804600,0.9755600814663951,0.024439918533604887,12,0,1012,5,81,"Census Tract 8046, Monmouth County, New Jersey",0,0,0,0,12,0,0,932,26,958,722,256,2606,24,10,100,982,24,978,34
34025804700,0.03225806451612903,0.967741935483871,48,0,0,0,0,"Census Tract 8047, Monmouth County, New Jersey",0,0,0,36,12,0,0,4,0,4,0,0,13,0,0,0,124,120,0,0
34025804800,0.93099006256901,0.06900993743099006,3346,0,1440,976,34,"Census Tract 8048, Monmouth County, New Jersey",0,209,168,2327,485,132,25,2697,2362,5059,748,361,5102,306,25,4588,5434,375,1109,331
34025805001,0.9334871203383314,0.06651287966166859,2146,0,744,89,38,"Census Tract 8050.01, Monmouth County, New Jersey",0,640,99,107,684,370,246,640,1788,2428,316,109,1396,263,56,3267,2601,173,425,319
34025805100,0.9492260061919504,0.05077399380804953,129,0.17956656346749225,1755,77,48,"Census Tract 8051, Monmouth County, New Jersey",290,50,33,0,21,25,0,1272,261,1533,1052,670,3464,0,33,725,1615,82,1722,33
34025805300,0.9398563734290843,0.06014362657091562,135,0,2061,42,83,"Census Tract 8053, Monmouth County, New Jersey",0,0,0,107,0,11,17,1797,297,2094,842,1168,4796,51,0,820,2228,134,2010,51
34025805400,0.841845140032949,0.15815485996705106,1299,0.007825370675453048,1132,145,57,"Census Tract 8054, Monmouth County, New Jersey",19,188,208,397,162,136,208,987,1057,2044,438,467,2249,227,0,2502,2428,384,905,227
34025805500,0.8869300911854103,0.11306990881458967,658,0,706,193,99,"Census Tract 8055, Monmouth County, New Jersey",0,199,87,85,32,38,217,798,661,1459,374,291,2361,15,26,1684,1645,186,665,41
34025805600,0.9089887640449438,0.09101123595505618,539,0,407,281,103,"Census Tract 8056, Monmouth County, New Jersey",0,36,55,140,131,64,113,238,571,809,15,325,763,44,23,1689,890,81,340,67
34025805700,0.9122340425531915,0.08776595744680851,488,0,593,77,15,"Census Tract 8057, Monmouth County, New Jersey",0,0,84,10,26,189,179,521,508,1029,294,272,1422,10,17,1649,1128,99,566,27
34025805800,0.8389694041867954,0.1610305958132045,1512,0,351,252,197,"Census Tract 8058, Monmouth County, New Jersey",0,67,237,726,128,143,211,236,1327,1563,76,53,543,222,0,3201,1863,300,129,222
34025805900,0.9262213359920239,0.07377866400797607,882,0,1688,182,29,"Census Tract 8059, Monmouth County, New Jersey",0,70,113,0,172,189,338,886,972,1858,525,931,2468,209,23,2937,2006,148,1456,232
34025806000,0.6925520649488175,0.3074479350511825,1977,0,1014,150,187,"Census Tract 8060, Monmouth County, New Jersey",0,184,339,845,171,273,165,817,1145,1962,413,570,1666,0,31,2149,2833,871,983,31
34025806100,0.6489479512735327,0.35105204872646734,567,0,1084,49,27,"Census Tract 8061, Monmouth County, New Jersey",0,103,200,42,106,88,28,735,437,1172,349,645,1926,90,0,1229,1806,634,994,90
34025806201,0.8416289592760181,0.1583710407239819,24,0.011312217194570135,1158,12,66,"Census Tract 8062.01, Monmouth County, New Jersey",10,0,0,0,0,0,24,651,93,744,472,511,1941,9,166,358,884,140,983,175
34025806202,0.9501385041551247,0.04986149584487535,397,0,1488,89,29,"Census Tract 8062.02, Monmouth County, New Jersey",0,116,106,76,9,71,19,1234,481,1715,714,597,3417,99,78,1009,1805,90,1311,177
34025806300,0.6780876494023904,0.3219123505976096,86,0,1220,25,77,"Census Tract 8063, Monmouth County, New Jersey",0,29,0,0,5,38,14,752,99,851,571,643,2098,0,6,241,1255,404,1214,6
34025806400,0.9573560767590619,0.042643923240938165,22,0,2223,75,107,"Census Tract 8064, Monmouth County, New Jersey",0,0,0,22,0,0,0,1652,144,1796,996,1201,4558,0,26,226,1876,80,2197,26
34025806501,0.9481596682218766,0.05184033177812338,1166,0,371,129,53,"Census Tract 8065.01, Monmouth County, New Jersey",0,336,185,302,143,113,87,690,1139,1829,239,68,1347,64,0,2757,1929,100,307,64
34025806502,0.9460649422124381,0.05393505778756191,1070,0,596,76,43,"Census Tract 8065.02, Monmouth County, New Jersey",0,378,171,107,135,238,41,683,1036,1719,254,160,1728,110,72,1670,1817,98,414,182
34025806503,0.97131931166348,0.028680688336520075,112,0,1904,41,59,"Census Tract 8065.03, Monmouth County, New Jersey",0,0,78,34,0,0,0,1497,27,1524,1070,834,3967,0,0,27,1569,45,1904,0
34025806504,0.9559183673469388,0.044081632653061226,888,0,717,23,19,"Census Tract 8065.04, Monmouth County, New Jersey",0,409,32,30,275,142,0,327,844,1171,283,294,1015,54,86,1775,1225,54,577,140
34025806600,0.8870967741935484,0.11290322580645161,104,0,2656,68,46,"Census Tract 8066, Monmouth County, New Jersey",0,90,0,0,0,0,14,1653,217,1870,1625,898,4636,0,133,765,2108,238,2523,133
34025807003,0.776661514683153,0.223338485316847,2273,0,304,556,146,"Census Tract 8070.03, Monmouth County, New Jersey",0,234,379,661,242,420,337,234,1776,2010,0,47,455,81,176,3718,2588,578,47,257
34025807004,0.8023360287511231,0.1976639712488769,2012,0,252,324,112,"Census Tract 8070.04, Monmouth County, New Jersey",0,258,443,855,190,179,87,388,1398,1786,56,88,659,36,72,2217,2226,440,144,108
34025807100,0.9022900763358779,0.09770992366412214,672,0,806,347,117,"Census Tract 8071, Monmouth County, New Jersey",0,24,262,108,17,79,182,558,624,1182,368,328,1404,52,58,1146,1310,128,696,110
34025807200,0.823271130625686,0.17672886937431395,700,0,205,264,108,"Census Tract 8072, Monmouth County, New Jersey",0,286,32,26,168,74,114,47,703,750,50,11,145,61,83,2118,911,161,61,144
34025807300,0.830267558528428,0.1697324414715719,531,0,262,408,109,"Census Tract 8073, Monmouth County, New Jersey",0,59,30,19,40,133,250,186,807,993,109,131,666,8,14,2896,1196,203,240,22
34025807400,0.6487467018469657,0.3512532981530343,1523,0,408,310,123,"Census Tract 8074, Monmouth County, New Jersey",0,125,186,228,401,312,271,780,1187,1967,227,112,1383,69,0,1608,3032,1065,339,69
34025807500,0.9068162208800691,0.09318377911993098,276,0.023295944779982744,621,162,24,"Census Tract 8075, Monmouth County, New Jersey",27,0,0,50,77,78,71,560,491,1051,141,441,1792,39,0,1124,1159,108,582,39
34025807600,0.8667724028548771,0.13322759714512292,468,0,625,277,40,"Census Tract 8076, Monmouth County, New Jersey",0,129,118,50,20,35,116,371,722,1093,395,107,981,38,85,1958,1261,168,502,123
34025807700,0.908289241622575,0.09171075837742504,654,0.06172839506172839,1312,232,0,"Census Tract 8077, Monmouth County, New Jersey",105,94,92,334,58,66,10,787,758,1545,334,651,2473,327,0,1663,1701,156,985,327
34025807800,0.9542319749216301,0.045768025078369905,53,0,2025,27,28,"Census Tract 8078, Monmouth County, New Jersey",0,0,0,0,8,8,37,1492,30,1522,980,1045,4151,0,0,122,1595,73,2025,0
34025807900,0.8947704081632653,0.10522959183673469,500,0.003826530612244898,838,86,41,"Census Tract 8079, Monmouth County, New Jersey",6,241,105,64,90,0,0,882,521,1403,391,355,2292,27,65,1224,1568,165,746,92
34025808001,0.9559859154929577,0.04401408450704225,18,0,1836,31,36,"Census Tract 8080.01, Monmouth County, New Jersey",0,0,0,0,0,0,18,1549,80,1629,891,816,3938,8,121,253,1704,75,1707,129
34025808002,0.9617486338797814,0.03825136612021858,141,0,704,34,38,"Census Tract 8080.02, Monmouth County, New Jersey",0,16,0,42,59,12,12,725,155,880,256,448,1879,0,0,297,915,35,704,0
34025808100,0.9342453662842012,0.06575463371579876,817,0.05913503971756399,1243,257,13,"Census Tract 8081, Monmouth County, New Jersey",134,83,123,251,193,125,42,1280,837,2117,575,580,2893,29,59,1735,2266,149,1155,88
34025808200,0.6953099376844867,0.30469006231551327,1404,0,1002,212,152,"Census Tract 8082, Monmouth County, New Jersey",0,423,507,20,201,71,182,962,1158,2120,506,434,1985,15,47,2231,3049,929,940,62
34025808300,0.6770045385779122,0.32299546142208774,395,0,644,70,72,"Census Tract 8083, Monmouth County, New Jersey",0,89,124,35,7,50,90,592,303,895,366,268,1172,5,5,584,1322,427,634,10
34025808401,0.6800526662277815,0.31994733377221857,667,0.028308097432521395,502,69,81,"Census Tract 8084.01, Monmouth County, New Jersey",43,157,202,68,89,77,74,560,473,1033,231,218,1341,53,0,829,1519,486,449,53
34025808402,0.693145710394916,0.306854289605084,735,0,589,121,68,"Census Tract 8084.02, Monmouth County, New Jersey",0,47,131,84,77,140,256,692,835,1527,288,239,1496,23,39,1961,2203,676,527,62
34025808500,0.8836545324768023,0.11634546752319772,388,0.030692362598144184,3740,98,45,"Census Tract 8085, Monmouth County, New Jersey",86,95,84,109,78,0,22,2005,471,2476,1917,1661,5382,46,116,872,2802,326,3578,162
34025808600,1,0,249,0,1866,80,18,"Census Tract 8086, Monmouth County, New Jersey",0,53,13,0,151,32,0,1687,385,2072,974,892,4904,0,0,1094,2072,0,1866,0
34025808701,0.9285352255448556,0.07146477445514444,376,0.020780537252914344,1731,141,41,"Census Tract 8087.01, Monmouth County, New Jersey",41,24,55,161,44,75,17,1437,395,1832,1259,433,4203,39,0,595,1973,141,1692,39
34025808702,0.9019607843137255,0.09803921568627451,88,0,1628,19,7,"Census Tract 8087.02, Monmouth County, New Jersey",0,0,0,10,60,18,0,1376,50,1426,1108,501,3823,19,0,151,1581,155,1609,19
34025808800,0.9365079365079365,0.06349206349206349,320,0,1699,124,58,"Census Tract 8088, Monmouth County, New Jersey",0,7,27,211,39,0,36,1392,437,1829,1030,533,3605,108,28,827,1953,124,1563,136
34025808900,0.8847784200385357,0.11522157996146436,916,0,1279,180,206,"Census Tract 8089, Monmouth County, New Jersey",0,212,114,137,146,239,68,1389,907,2296,542,679,3158,29,29,1437,2595,299,1221,58
34025809000,0.6776315789473685,0.3223684210526316,117,0.016917293233082706,377,83,22,"Census Tract 8090, Monmouth County, New Jersey",18,3,13,0,33,7,61,445,276,721,226,120,1009,31,0,662,1064,343,346,31
34025809100,0.5791487326637972,0.42085126733620276,289,0.010043041606886656,1165,24,114,"Census Tract 8091, Monmouth County, New Jersey",21,0,0,124,22,71,72,956,255,1211,626,520,2360,8,11,580,2091,880,1146,19
34025809200,0.6093133385951065,0.39068666140489344,44,0.02367797947908445,705,5,39,"Census Tract 8092, Monmouth County, New Jersey",30,0,13,0,0,14,17,740,32,772,357,348,1624,0,0,103,1267,495,705,0
34025809301,0.8867924528301887,0.11320754716981132,220,0,1024,65,9,"Census Tract 8093.01, Monmouth County, New Jersey",0,46,29,0,32,48,65,963,212,1175,423,554,2543,47,0,591,1325,150,977,47
34025809302,0.538210624417521,0.461789375582479,216,0,980,38,37,"Census Tract 8093.02, Monmouth County, New Jersey",0,0,38,0,8,49,121,1002,153,1155,599,354,2316,0,27,345,2146,991,953,27
34025809400,0.830999066293184,0.16900093370681607,207,0.003734827264239029,1363,43,26,"Census Tract 8094, Monmouth County, New Jersey",8,42,0,0,0,109,56,1617,163,1780,656,685,4397,22,0,312,2142,362,1341,22
34025809501,0.9210526315789473,0.07894736842105263,183,0.017303532804614274,3617,48,769,"Census Tract 8095.01, Monmouth County, New Jersey",48,79,27,54,23,0,0,2311,244,2555,3038,579,7854,0,0,628,2774,219,3617,0
34025809502,0.9861603974449965,0.013839602555003548,364,0.0383250532292406,2575,53,560,"Census Tract 8095.02, Monmouth County, New Jersey",108,80,0,0,207,57,20,2489,290,2779,1919,656,7462,0,0,959,2818,39,2575,0
34025809600,0.9410774410774411,0.058922558922558925,234,0.013468013468013467,3270,97,430,"Census Tract 8096, Monmouth County, New Jersey",32,49,0,0,8,132,45,2118,118,2236,2235,1035,6866,0,0,470,2376,140,3270,0
34025809701,0.9630281690140845,0.03697183098591549,57,0,2196,21,399,"Census Tract 8097.01, Monmouth County, New Jersey",0,0,0,33,0,0,24,1609,32,1641,1335,850,5359,0,11,130,1704,63,2185,11
34025809703,0.9354654483152485,0.06453455168475157,7,0,1572,143,379,"Census Tract 8097.03, Monmouth County, New Jersey",0,0,0,0,7,0,0,1564,74,1638,713,859,4116,0,0,204,1751,113,1572,0
34025809704,0.9872068230277186,0.01279317697228145,75,0,1852,0,596,"Census Tract 8097.04, Monmouth County, New Jersey",0,23,12,9,0,0,31,1733,119,1852,1208,636,5617,0,8,373,1876,24,1844,8
34025809901,0.9402143260011281,0.05978567399887197,0,0,1931,39,174,"Census Tract 8099.01, Monmouth County, New Jersey",0,0,0,0,0,0,0,1608,59,1667,1163,748,4820,20,0,156,1773,106,1911,20
34025809902,0.9733671528218135,0.02663284717818643,158,0,1281,44,106,"Census Tract 8099.02, Monmouth County, New Jersey",0,11,0,24,0,103,20,1361,174,1535,781,366,4215,134,0,483,1577,42,1147,134
34025809903,0.6060606060606061,0.3939393939393939,60,0,0,0,0,"Census Tract 8099.03, Monmouth County, New Jersey",0,0,0,0,4,18,38,0,60,60,0,0,0,0,0,216,99,39,0,0
34025810001,0.984036488027366,0.01596351197263398,41,0.027936145952109463,2028,30,199,"Census Tract 8100.01, Monmouth County, New Jersey",49,0,0,0,15,0,26,1540,186,1726,1180,848,5068,0,0,715,1754,28,2028,0
34025810002,0.8893905191873589,0.11060948081264109,1428,0,792,408,9,"Census Tract 8100.02, Monmouth County, New Jersey",0,752,0,39,499,138,0,1287,683,1970,397,312,2560,39,44,976,2215,245,709,83
34025810003,0.9860606060606061,0.013939393939393939,55,0,2290,28,201,"Census Tract 8100.03, Monmouth County, New Jersey",0,0,0,0,27,0,28,1523,104,1627,1468,809,4678,13,0,380,1650,23,2277,13
34025810004,0.9783653846153846,0.021634615384615384,38,0,1464,8,568,"Census Tract 8100.04, Monmouth County, New Jersey",0,0,0,0,27,0,11,1188,33,1221,861,603,4021,0,0,62,1248,27,1464,0
34025810101,0.9794617563739377,0.020538243626062325,104,0,2022,17,392,"Census Tract 8101.01, Monmouth County, New Jersey",0,0,7,97,0,0,0,1301,82,1383,1335,687,4146,0,0,119,1412,29,2022,0
34025810102,0.9531941808981658,0.04680581910183428,135,0,1533,24,395,"Census Tract 8101.02, Monmouth County, New Jersey",0,20,0,10,68,0,37,1296,211,1507,1077,437,3558,0,19,612,1581,74,1514,19
34025810200,0.9470411663807891,0.05295883361921098,811,0,1820,275,580,"Census Tract 8102, Monmouth County, New Jersey",0,360,25,247,0,0,179,3834,583,4417,1496,324,11666,0,0,1092,4664,247,1820,0
34025810300,0.9144981412639405,0.08550185873605948,282,0.011152416356877323,499,65,87,"Census Tract 8103, Monmouth County, New Jersey",9,37,29,53,54,25,84,480,258,738,298,201,1340,0,0,613,807,69,499,0
34025810401,0.9531380753138076,0.04686192468619247,11,0,1366,19,183,"Census Tract 8104.01, Monmouth County, New Jersey",0,0,0,0,0,0,11,1049,90,1139,733,613,3324,20,0,391,1195,56,1346,20
34025810402,0.9621928166351607,0.03780718336483932,348,0,2996,21,211,"Census Tract 8104.02, Monmouth County, New Jersey",0,86,0,0,118,100,44,2249,296,2545,2339,657,7185,0,0,723,2645,100,2996,0
34025810501,0.9534613147178592,0.04653868528214078,699,0,1460,47,62,"Census Tract 8105.01, Monmouth County, New Jersey",0,259,33,8,312,87,0,977,662,1639,704,608,2904,148,0,1586,1719,80,1312,148
34025810502,1,0,545,0,2520,185,450,"Census Tract 8105.02, Monmouth County, New Jersey",0,40,70,38,381,16,0,2156,478,2634,1277,1191,7178,33,19,850,2634,0,2468,52
34025810503,0.8577023498694517,0.1422976501305483,1000,0,610,167,150,"Census Tract 8105.03, Monmouth County, New Jersey",0,232,53,255,323,46,91,1247,724,1971,481,129,2485,0,0,1259,2298,327,610,0
34025810600,0.9334763948497854,0.06652360515021459,477,0.1255364806866953,1991,207,228,"Census Tract 8106, Monmouth County, New Jersey",351,32,0,174,257,0,14,2186,424,2610,1482,434,5525,37,38,692,2796,186,1916,75
34025810700,0.9548472775564409,0.0451527224435591,125,0,631,68,32,"Census Tract 8107, Monmouth County, New Jersey",0,0,11,0,46,55,13,532,187,719,264,329,1375,6,32,437,753,34,593,38
34025810800,0.8784615384615385,0.12153846153846154,774,0,629,313,98,"Census Tract 8108, Monmouth County, New Jersey",0,21,43,428,111,45,126,291,851,1142,206,165,858,161,97,2634,1300,158,371,258
34025810900,0.9467680608365019,0.053231939163498096,297,0,715,181,172,"Census Tract 8109, Monmouth County, New Jersey",0,30,0,4,172,47,44,615,381,996,422,293,1481,0,0,1408,1052,56,715,0
34025811000,0.9171554252199413,0.08284457478005865,553,0,1137,314,250,"Census Tract 8110, Monmouth County, New Jersey",0,69,10,181,34,96,163,516,735,1251,486,301,1342,294,56,2253,1364,113,787,350
34025811101,0.9627942293090357,0.03720577069096431,172,0,1066,168,129,"Census Tract 8111.01, Monmouth County, New Jersey",0,17,0,83,34,19,19,2186,350,2536,819,225,4850,22,0,733,2634,98,1044,22
34025811102,0.8869739478957915,0.11302605210420842,177,0.08697394789579159,2016,33,138,"Census Tract 8111.02, Monmouth County, New Jersey",217,0,0,0,105,0,72,1996,217,2213,1310,706,5755,0,0,917,2495,282,2016,0
34025811200,0.952263779527559,0.04773622047244094,148,0,2551,66,167,"Census Tract 8112, Monmouth County, New Jersey",0,0,0,67,0,38,43,1594,341,1935,1476,989,5013,86,0,987,2032,97,2465,86
34025811301,0.926489226869455,0.07351077313054499,538,0.09252217997465145,1265,66,164,"Census Tract 8113.01, Monmouth County, New Jersey",219,22,0,49,416,40,11,1673,520,2193,780,355,5021,130,0,1265,2367,174,1135,130
34025811303,0.9804332634521313,0.019566736547868623,28,0,1895,11,112,"Census Tract 8113.03, Monmouth County, New Jersey",0,0,0,0,0,28,0,1300,103,1403,1085,810,3823,0,0,412,1431,28,1895,0
34025811304,0.9284452296819788,0.0715547703180212,53,0.024734982332155476,1414,53,92,"Census Tract 8113.04, Monmouth County, New Jersey",28,0,0,44,0,0,9,1005,46,1051,692,678,3032,9,35,95,1132,81,1370,44
34025811401,0.984966592427617,0.015033407572383074,0,0,2922,28,183,"Census Tract 8114.01, Monmouth County, New Jersey",0,0,0,0,0,0,0,1723,46,1769,1583,1339,5858,0,0,182,1796,27,2922,0
34025811402,0.9552845528455285,0.044715447154471545,173,0.008807588075880758,1483,10,83,"Census Tract 8114.02, Monmouth County, New Jersey",13,34,0,0,105,5,29,1188,222,1410,624,813,3396,15,31,663,1476,66,1437,46
34025811501,0.9680746561886051,0.03192534381139489,34,0,2573,64,99,"Census Tract 8115.01, Monmouth County, New Jersey",0,0,34,0,0,0,0,1909,62,1971,1690,883,6123,0,0,118,2036,65,2573,0
34025811502,1,0,0,0.09750390015600624,1164,0,41,"Census Tract 8115.02, Monmouth County, New Jersey",125,0,0,0,0,0,0,1137,145,1282,751,386,3153,27,0,443,1282,0,1137,27
34025811600,0.9593220338983051,0.04067796610169491,253,0,393,34,8,"Census Tract 8116, Monmouth County, New Jersey",0,70,0,23,81,44,35,285,281,566,167,200,759,22,4,639,590,24,367,26
34025811900,0.9306184012066365,0.0693815987933635,0,0.015082956259426848,1830,47,98,"Census Tract 8119, Monmouth County, New Jersey",40,0,0,0,0,0,0,2363,105,2468,984,775,6710,28,43,196,2652,184,1759,71
34025812000,0.9862068965517241,0.013793103448275862,111,0,788,15,14,"Census Tract 8120, Monmouth County, New Jersey",0,39,0,8,21,6,37,555,160,715,315,417,1586,33,23,317,725,10,732,56
34025812100,0.6567685589519651,0.34323144104803494,524,0,313,81,179,"Census Tract 8121, Monmouth County, New Jersey",0,104,88,87,123,89,33,477,275,752,124,145,919,11,33,459,1145,393,269,44
34025812200,0.849624060150376,0.15037593984962405,593,0,1238,150,48,"Census Tract 8122, Monmouth County, New Jersey",0,63,119,296,45,13,57,944,525,1469,398,607,2279,57,176,1016,1729,260,1005,233
34025812300,0.9640179910044977,0.035982008995502246,268,0.006496751624187906,1673,143,155,"Census Tract 8123, Monmouth County, New Jersey",13,69,4,19,120,45,11,1633,296,1929,814,747,4249,69,43,751,2001,72,1561,112
34025812400,0.47823660714285715,0.5217633928571429,173,0.010044642857142858,814,46,71,"Census Tract 8124, Monmouth County, New Jersey",18,29,28,0,40,35,41,665,192,857,384,385,1572,22,23,374,1792,935,769,45
34025812501,0.8931947069943289,0.10680529300567108,16,0.0222117202268431,2615,0,301,"Census Tract 8125.01, Monmouth County, New Jersey",47,0,0,0,0,0,16,1806,84,1890,1756,859,5775,0,0,215,2116,226,2615,0
34025812502,0.9672131147540983,0.03278688524590164,60,0,2223,35,144,"Census Tract 8125.02, Monmouth County, New Jersey",0,0,0,6,21,2,31,1545,107,1652,1634,531,5052,58,0,203,1708,56,2165,58
34025990000,NaN,NaN,0,NaN,0,0,0,"Census Tract 9900, Monmouth County, New Jersey",0,0,0,0,0,0,0,0,0,0,0,0,0,0,0,0,0,0,0,0
34027040101,0.9628851540616247,0.03711484593837535,474,0,1350,62,87,"Census Tract 401.01, Morris County, New Jersey",0,31,315,61,22,0,45,858,517,1375,573,618,2763,55,104,1272,1428,53,1191,159
34027040102,0.9588209796272215,0.0411790203727785,647,0,1990,28,104,"Census Tract 401.02, Morris County, New Jersey",0,144,100,46,116,142,99,1877,335,2212,926,1015,4563,49,0,1031,2307,95,1941,49
34027040200,0.9500381388253242,0.04996186117467582,373,0,2898,90,176,"Census Tract 402, Morris County, New Jersey",0,77,0,128,79,65,24,2129,362,2491,1504,1343,6087,51,0,844,2622,131,2847,51
34027040300,0.9400101677681749,0.059989832231825115,1889,0.004067107269954245,2510,599,325,"Census Tract 403, Morris County, New Jersey",16,118,193,1287,166,55,70,2864,834,3698,1423,1087,7126,0,0,1126,3934,236,2510,0
34027040400,0.9739084132055378,0.026091586794462194,977,0,1089,11,106,"Census Tract 404, Morris County, New Jersey",0,37,285,567,19,34,35,1263,566,1829,539,511,2988,39,0,1238,1878,49,1050,39
34027040500,0.9404163675520459,0.05958363244795405,584,0,1012,111,120,"Census Tract 405, Morris County, New Jersey",0,54,63,76,63,63,265,754,556,1310,582,334,2337,67,29,1174,1393,83,916,96
34027040600,0.9950556242274413,0.004944375772558714,451,0.004944375772558714,1399,27,146,"Census Tract 406, Morris County, New Jersey",8,171,50,25,45,64,96,1133,477,1610,779,466,3151,154,0,994,1618,8,1245,154
34027040701,0.9819186338523355,0.01808136614766449,13,0,2592,0,143,"Census Tract 407.01, Morris County, New Jersey",0,0,0,0,0,0,13,1795,160,1955,1705,857,5424,30,0,454,1991,36,2562,30
34027040702,0.9138263665594856,0.08617363344051447,237,0.005787781350482315,1282,27,81,"Census Tract 407.02, Morris County, New Jersey",9,42,26,76,35,58,0,1144,277,1421,792,435,3434,55,0,815,1555,134,1227,55
34027040801,0.9472222222222222,0.05277777777777778,62,0,1930,9,120,"Census Tract 408.01, Morris County, New Jersey",0,9,19,8,9,0,17,1605,100,1705,1072,810,5059,9,39,200,1800,95,1882,48
34027040803,0.9663099484740388,0.033690051525961155,769,0,2164,61,247,"Census Tract 408.03, Morris County, New Jersey",0,170,352,30,136,64,17,1555,883,2438,1558,578,4807,0,28,1725,2523,85,2136,28
34027040804,0.9434782608695652,0.05652173913043478,199,0,1148,16,142,"Census Tract 408.04, Morris County, New Jersey",0,89,8,0,44,58,0,1448,71,1519,883,259,3566,0,6,221,1610,91,1142,6
34027040805,0.9274826789838337,0.07251732101616629,137,0,1774,28,352,"Census Tract 408.05, Morris County, New Jersey",0,0,17,11,67,10,32,1865,143,2008,922,852,5411,0,0,354,2165,157,1774,0
34027040900,0.9889538661468485,0.011046133853151396,92,0,1576,52,129,"Census Tract 409, Morris County, New Jersey",0,0,0,59,11,13,9,1363,159,1522,811,752,3881,13,0,314,1539,17,1563,13
34027041000,0.8506036217303823,0.1493963782696177,715,0,1213,107,92,"Census Tract 410, Morris County, New Jersey",0,45,22,11,75,186,376,1087,604,1691,467,539,2936,154,53,1514,1988,297,1006,207
34027041100,0.9699453551912568,0.030054644808743168,430,0,731,92,76,"Census Tract 411, Morris County, New Jersey",0,62,37,8,7,50,266,854,566,1420,261,362,2197,50,58,1513,1464,44,623,108
34027041200,0.9706513958482462,0.02934860415175376,29,0,1069,11,240,"Census Tract 412, Morris County, New Jersey",0,0,0,0,29,0,0,1257,99,1356,645,386,3988,0,38,286,1397,41,1031,38
34027041300,0.8848288621646624,0.11517113783533765,776,0,2043,276,69,"Census Tract 413, Morris County, New Jersey",0,53,228,446,28,0,21,1381,532,1913,1027,995,4017,11,10,663,2162,249,2022,21
34027041400,0.9819665092314298,0.018033490768570203,166,0,2279,52,223,"Census Tract 414, Morris County, New Jersey",0,19,31,15,0,0,101,2078,209,2287,1326,953,5461,0,0,484,2329,42,2279,0
34027041500,0.9472996515679443,0.052700348432055746,148,0,2065,39,134,"Census Tract 415, Morris County, New Jersey",0,47,29,0,38,0,34,1900,275,2175,1175,846,5330,44,0,609,2296,121,2021,44
34027041601,0.9293478260869565,0.07065217391304347,1243,0,1629,61,176,"Census Tract 416.01, Morris County, New Jersey",0,496,247,261,188,21,30,1903,833,2736,1085,471,4712,37,36,1738,2944,208,1556,73
34027041602,0.8952734012974977,0.10472659870250231,140,0,911,52,63,"Census Tract 416.02, Morris County, New Jersey",0,91,32,11,0,6,0,752,214,966,373,496,2050,0,42,739,1079,113,869,42
34027041603,0.9697968149368479,0.030203185063152116,1090,0,1456,133,55,"Census Tract 416.03, Morris County, New Jersey",0,224,231,356,106,120,53,766,1000,1766,471,388,2305,444,153,2238,1821,55,859,597
34027041604,0.9750639386189258,0.024936061381074168,0,0.021099744245524295,1845,8,65,"Census Tract 416.04, Morris County, New Jersey",33,0,0,0,0,0,0,1461,64,1525,911,913,4414,10,11,156,1564,39,1824,21
34027041701,0.9462827675118178,0.05371723248818221,1151,0,1458,124,222,"Census Tract 417.01, Morris County, New Jersey",0,314,348,116,170,47,156,1105,1097,2202,654,613,3066,191,0,2718,2327,125,1267,191
34027041702,0.9081214109926169,0.0918785890073831,20,0,1343,113,49,"Census Tract 417.02, Morris County, New Jersey",0,10,0,0,0,0,10,992,115,1107,659,646,2841,0,38,263,1219,112,1305,38
34027041704,0.9727034120734908,0.027296587926509186,806,0,1268,36,244,"Census Tract 417.04, Morris County, New Jersey",0,238,211,214,15,93,35,1013,840,1853,603,579,3090,79,7,1648,1905,52,1182,86
34027041705,1,0,282,0,704,216,60,"Census Tract 417.05, Morris County, New Jersey",0,0,12,270,0,0,0,367,311,678,274,359,1115,47,24,461,678,0,633,71
34027041706,0.9849170437405732,0.015082956259426848,2203,0,1052,147,188,"Census Tract 417.06, Morris County, New Jersey",0,674,629,368,76,349,107,400,2212,2612,567,149,1193,204,132,4422,2652,40,716,336
34027041801,0.9811659192825112,0.01883408071748879,714,0,512,62,46,"Census Tract 418.01, Morris County, New Jersey",0,274,129,36,93,92,90,352,742,1094,175,296,1256,8,33,1593,1115,21,471,41
34027041802,0.9189665296535525,0.08103347034644745,23,0,2027,56,85,"Census Tract 418.02, Morris County, New Jersey",0,0,0,0,0,23,0,1448,117,1565,1115,866,4522,46,0,330,1703,138,1981,46
34027041803,0.97052913596785,0.029470864032150032,10,0.008707300736771601,1244,10,195,"Census Tract 418.03, Morris County, New Jersey",13,0,10,0,0,0,0,1379,70,1449,634,610,4343,0,0,290,1493,44,1244,0
34027041901,1,0,4,0,2615,55,161,"Census Tract 419.01, Morris County, New Jersey",0,0,0,0,0,0,4,1942,56,1998,1069,1531,5976,0,15,152,1998,0,2600,15
34027041902,0.9314692982456141,0.06853070175438597,332,0,2029,31,165,"Census Tract 419.02, Morris County, New Jersey",0,94,7,34,71,73,53,1552,147,1699,1218,789,4508,22,0,475,1824,125,2007,22
34027042000,0.967425025853154,0.03257497414684592,414,0,1914,108,111,"Census Tract 420, Morris County, New Jersey",0,47,9,175,57,32,94,1476,395,1871,924,948,3916,42,0,758,1934,63,1872,42
34027042100,0.985,0.015,187,0,1553,0,70,"Census Tract 421, Morris County, New Jersey",0,111,0,23,53,0,0,1465,111,1576,860,684,3790,0,9,269,1600,24,1544,9
34027042200,0.9108869272803699,0.0891130727196301,670,0,1926,69,81,"Census Tract 422, Morris County, New Jersey",0,138,121,54,185,130,42,1598,569,2167,693,1218,4452,0,15,1126,2379,212,1911,15
34027042301,0.9678756476683937,0.03212435233160622,137,0,758,38,187,"Census Tract 423.01, Morris County, New Jersey",0,5,29,42,21,31,9,732,202,934,293,465,1986,0,0,500,965,31,758,0
34027042302,0.9171875,0.0828125,278,0,1382,52,152,"Census Tract 423.02, Morris County, New Jersey",0,59,100,30,81,8,0,1073,101,1174,769,605,2985,8,0,147,1280,106,1374,8
34027042500,0.9258662369057212,0.07413376309427881,0,0,1501,15,130,"Census Tract 425, Morris County, New Jersey",0,0,0,0,0,0,0,1120,29,1149,630,871,3153,0,0,133,1241,92,1501,0
34027042600,0.9339837398373984,0.06601626016260162,1119,0,1980,198,296,"Census Tract 426, Morris County, New Jersey",0,325,18,234,319,163,60,1681,1191,2872,1117,785,4102,78,0,2756,3075,203,1902,78
34027042700,0.8937259923175416,0.10627400768245839,481,0,856,67,451,"Census Tract 427, Morris County, New Jersey",0,0,100,0,146,208,27,989,407,1396,613,221,3115,22,0,1003,1562,166,834,22
34027042800,0.9526813880126183,0.0473186119873817,102,0,1420,16,558,"Census Tract 428, Morris County, New Jersey",0,0,10,0,0,43,49,1367,143,1510,813,588,4314,19,0,385,1585,75,1401,19
34027042900,0.9882352941176471,0.011764705882352941,686,0,1024,174,212,"Census Tract 429, Morris County, New Jersey",0,102,19,71,136,125,233,932,664,1596,484,460,2427,41,39,1313,1615,19,944,80
34027043000,0.9806224310041104,0.019377568995889608,465,0,1356,80,264,"Census Tract 430, Morris County, New Jersey",0,30,20,24,104,105,182,1148,522,1670,570,696,3485,90,0,982,1703,33,1266,90
34027043100,0.9654320987654321,0.0345679012345679,140,0,1026,49,295,"Census Tract 431, Morris County, New Jersey",0,23,47,0,45,25,0,1009,164,1173,575,441,3289,0,10,199,1215,42,1016,10
34027043200,0.9162162162162162,0.08378378378378379,279,0,659,19,122,"Census Tract 432, Morris County, New Jersey",0,34,10,60,76,14,85,633,384,1017,305,303,2021,0,51,910,1110,93,608,51
34027043301,0.9306839186691312,0.06931608133086876,345,0,940,29,74,"Census Tract 433.01, Morris County, New Jersey",0,91,43,11,50,80,70,753,254,1007,480,433,2356,13,14,448,1082,75,913,27
34027043302,0.8738351254480287,0.12616487455197134,300,0,1021,48,94,"Census Tract 433.02, Morris County, New Jersey",0,158,0,21,44,77,0,1069,150,1219,589,432,2574,0,0,423,1395,176,1021,0
34027043303,0.9842370744010088,0.015762925598991173,153,0.005674653215636823,1353,18,134,"Census Tract 433.03, Morris County, New Jersey",9,77,41,0,35,0,0,1450,111,1561,702,642,3464,9,0,154,1586,25,1344,9
34027043401,0.9761740331491713,0.02382596685082873,621,0.017265193370165747,2087,42,157,"Census Tract 434.01, Morris County, New Jersey",50,181,55,58,99,24,204,2125,702,2827,962,1048,5177,57,20,1373,2896,69,2010,77
34027043402,0.971007371007371,0.028992628992628992,119,0,2260,9,130,"Census Tract 434.02, Morris County, New Jersey",0,0,0,0,0,0,119,1797,179,1976,960,1249,4662,51,0,614,2035,59,2209,51
34027043500,0.9231372549019607,0.07686274509803921,850,0,517,234,115,"Census Tract 435, Morris County, New Jersey",0,91,34,40,214,67,404,360,817,1177,141,309,1125,67,0,2218,1275,98,450,67
34027043600,0.9552859618717504,0.04471403812824957,2200,0,885,145,148,"Census Tract 436, Morris County, New Jersey",0,376,617,499,165,370,173,793,1963,2756,419,194,2023,182,90,3730,2885,129,613,272
34027043700,0.9528676888131743,0.04713231118682567,928,0,867,96,77,"Census Tract 437, Morris County, New Jersey",0,144,52,233,124,234,141,935,743,1678,597,231,2091,39,0,1271,1761,83,828,39
34027043800,0.8391031981536432,0.16089680184635674,2054,0,1735,322,66,"Census Tract 438, Morris County, New Jersey",0,16,388,827,106,155,562,944,1601,2545,460,945,2495,150,180,3330,3033,488,1405,330
34027043900,0.9467018469656993,0.05329815303430079,458,0,1254,85,442,"Census Tract 439, Morris County, New Jersey",0,93,16,76,185,61,27,1686,108,1794,810,444,4552,0,0,125,1895,101,1254,0
34027044000,0.9226957383548068,0.07730426164519326,360,0,1458,37,518,"Census Tract 440, Morris County, New Jersey",0,106,93,56,35,44,26,1564,298,1862,872,562,4972,24,0,585,2018,156,1434,24
34027044101,1,0,62,0,1131,10,210,"Census Tract 441.01, Morris County, New Jersey",0,0,23,29,0,10,0,1004,117,1121,631,459,2810,0,41,182,1121,0,1090,41
34027044102,0.9734684032802702,0.02653159671972986,326,0,2200,12,232,"Census Tract 441.02, Morris County, New Jersey",0,32,0,0,37,122,135,1766,252,2018,1315,870,4973,15,0,649,2073,55,2185,15
34027044200,0.8732476635514018,0.12675233644859812,43,0,1507,11,202,"Census Tract 442, Morris County, New Jersey",0,0,10,0,23,10,0,1332,163,1495,723,740,3562,0,44,275,1712,217,1463,44
34027044300,0.9439721792890263,0.05602782071097372,777,0,2309,171,74,"Census Tract 443, Morris County, New Jersey",0,340,22,0,122,62,231,1704,739,2443,1003,1081,4852,161,64,1538,2588,145,2084,225
34027044401,0.8156479217603912,0.1843520782396088,58,0,1718,45,36,"Census Tract 444.01, Morris County, New Jersey",0,0,0,0,0,44,14,1439,229,1668,957,748,3955,13,0,441,2045,377,1705,13
34027044403,0.9564974902398216,0.04350250976017847,28,0,2158,78,80,"Census Tract 444.03, Morris County, New Jersey",0,0,0,14,14,0,0,1551,164,1715,1311,805,4598,42,0,404,1793,78,2116,42
34027044404,0.9948320413436692,0.00516795865633075,36,0,2067,9,137,"Census Tract 444.04, Morris County, New Jersey",0,0,0,0,9,0,27,1485,55,1540,1020,1024,4258,0,23,118,1548,8,2044,23
34027044501,0.9184834123222749,0.08151658767772511,1412,0.009794628751974723,1519,119,166,"Census Tract 445.01, Morris County, New Jersey",31,276,429,241,134,183,149,2093,814,2907,1014,379,4888,84,42,1605,3165,258,1393,126
34027044502,0.945995145631068,0.054004854368932036,298,0,1826,63,120,"Census Tract 445.02, Morris County, New Jersey",0,144,32,14,63,45,0,1186,373,1559,1086,648,3719,51,41,794,1648,89,1734,92
34027044601,0.9223504721930745,0.0776495278069255,171,0,1867,51,59,"Census Tract 446.01, Morris County, New Jersey",0,8,66,0,40,17,40,1533,225,1758,1072,746,4234,49,0,541,1906,148,1818,49
34027044602,0.9559277214631996,0.044072278536800354,120,0.00881445570736007,2797,39,48,"Census Tract 446.02, Morris County, New Jersey",20,20,0,19,62,19,0,2074,95,2169,1493,1251,5421,0,53,229,2269,100,2744,53
34027044701,0.8507785467128027,0.14922145328719724,97,0,1985,87,75,"Census Tract 447.01, Morris County, New Jersey",0,10,0,12,65,0,10,1706,261,1967,778,1162,4081,17,28,638,2312,345,1940,45
34027044702,0.8875205254515599,0.11247947454844007,272,0.05090311986863711,1402,81,82,"Census Tract 447.02, Morris County, New Jersey",124,25,24,25,122,53,23,1698,464,2162,761,641,5006,0,0,985,2436,274,1402,0
34027044800,0.9158325750682439,0.08416742493175614,740,0,1421,312,158,"Census Tract 448, Morris County, New Jersey",0,0,38,86,112,74,430,1071,942,2013,841,462,3610,118,0,3541,2198,185,1303,118
34027044900,0.9196242171189979,0.08037578288100208,584,0,1057,277,229,"Census Tract 449, Morris County, New Jersey",0,37,79,129,79,118,142,961,801,1762,392,664,3135,1,0,2741,1916,154,1056,1
34027045000,0.915068493150685,0.08493150684931507,950,0.00821917808219178,920,365,132,"Census Tract 450, Morris County, New Jersey",15,167,92,176,101,130,284,492,1178,1670,184,476,1595,232,28,3213,1825,155,660,260
34027045100,0.9190569744597249,0.08094302554027505,922,0,1836,171,77,"Census Tract 451, Morris County, New Jersey",0,65,23,165,162,242,265,1193,1146,2339,753,878,3549,145,60,2959,2545,206,1631,205
34027045200,0.9406461307287753,0.059353869271224644,74,0,1245,35,56,"Census Tract 452, Morris County, New Jersey",0,0,0,0,0,0,74,1082,170,1252,428,789,3013,20,8,547,1331,79,1217,28
34027045300,0.9842431063590321,0.015756893640967922,422,0,1642,66,40,"Census Tract 453, Morris County, New Jersey",0,0,56,15,196,63,92,1487,262,1749,684,926,3928,32,0,520,1777,28,1610,32
34027045401,0.8391211906449326,0.16087880935506732,1031,0,1816,72,0,"Census Tract 454.01, Morris County, New Jersey",0,136,353,278,108,82,74,1663,705,2368,1083,699,4305,14,20,1197,2822,454,1782,34
34027045402,0.9054652880354506,0.09453471196454949,282,0.0054160512063023145,2223,35,63,"Census Tract 454.02, Morris County, New Jersey",11,21,0,9,37,61,154,1514,325,1839,882,1270,4034,71,0,1031,2031,192,2152,71
34027045501,0.9820828667413214,0.01791713325867861,0,0,2082,17,113,"Census Tract 455.01, Morris County, New Jersey",0,0,0,0,0,0,0,1745,9,1754,1102,971,4913,0,9,9,1786,32,2073,9
34027045502,0.9598039215686275,0.04019607843137255,361,0,2726,119,147,"Census Tract 455.02, Morris County, New Jersey",0,70,77,0,117,83,14,2629,308,2937,1624,1047,7770,26,29,651,3060,123,2671,55
34027045602,0.8995290423861853,0.10047095761381476,299,0,251,96,24,"Census Tract 456.02, Morris County, New Jersey",0,125,31,30,26,22,65,239,334,573,103,93,619,34,21,959,637,64,196,55
34027045603,0.9245283018867925,0.07547169811320754,1521,0,1050,153,46,"Census Tract 456.03, Morris County, New Jersey",0,619,353,314,80,105,50,722,1385,2107,477,367,2168,188,18,2833,2279,172,844,206
34027045701,0.9862204724409449,0.013779527559055118,177,0,1776,83,129,"Census Tract 457.01, Morris County, New Jersey",0,0,46,50,0,52,29,1763,241,2004,1020,728,5455,28,0,530,2032,28,1748,28
34027045703,0.983451536643026,0.016548463356973995,134,0,1392,25,101,"Census Tract 457.03, Morris County, New Jersey",0,11,25,0,0,33,65,1095,153,1248,719,673,3327,0,0,422,1269,21,1392,0
34027045704,0.97973713033954,0.020262869660460023,165,0,2139,43,135,"Census Tract 457.04, Morris County, New Jersey",0,16,17,0,51,42,39,1619,170,1789,1070,899,4713,144,26,460,1826,37,1969,170
34027045804,0.9808177688036346,0.019182231196365473,119,0,1608,8,81,"Census Tract 458.04, Morris County, New Jersey",0,9,0,0,15,49,46,1809,134,1943,970,638,5362,0,0,404,1981,38,1608,0
34027045901,0.9109062980030722,0.0890937019969278,91,0.06758832565284179,435,43,5,"Census Tract 459.01, Morris County, New Jersey",44,18,28,7,0,0,38,471,122,593,220,206,1222,3,6,336,651,58,426,9
34027045902,0.9478656403079077,0.052134359692092375,39,0,2562,9,253,"Census Tract 459.02, Morris County, New Jersey",0,0,0,0,19,0,20,2574,135,2709,1336,1226,7374,0,0,384,2858,149,2562,0
34027046000,0.9399460188933874,0.06005398110661268,609,0.006747638326585695,1182,43,10,"Census Tract 460, Morris County, New Jersey",10,258,39,7,98,82,125,669,724,1393,480,549,1827,69,84,1377,1482,89,1029,153
34027046103,0.8733064811424387,0.12669351885756133,1502,0,1804,247,82,"Census Tract 461.03, Morris County, New Jersey",0,740,219,139,47,323,34,1059,1326,2385,841,773,3332,85,105,2319,2731,346,1614,190
34027046104,0.9474959612277868,0.05250403877221325,844,0,2283,44,115,"Census Tract 461.04, Morris County, New Jersey",0,367,246,26,55,121,29,1536,810,2346,1553,578,4682,65,87,1933,2476,130,2131,152
34027046105,0.9413439635535308,0.058656036446469245,2025,0,1525,184,142,"Census Tract 461.05, Morris County, New Jersey",0,916,462,109,298,160,80,1339,1967,3306,521,656,3699,260,88,4480,3512,206,1177,348
34027046106,0.9555555555555556,0.044444444444444446,278,0.001736111111111111,2259,183,115,"Census Tract 461.06, Morris County, New Jersey",5,39,96,64,0,27,52,2393,359,2752,1370,794,7411,0,95,967,2880,128,2164,95
34027046201,0.9490302210193956,0.05096977898060442,491,0,1836,113,101,"Census Tract 462.01, Morris County, New Jersey",0,129,57,23,160,95,27,1644,460,2104,1098,670,4973,68,0,943,2217,113,1768,68
34027046202,0.9244410177332305,0.07555898226676946,0,0,1584,14,31,"Census Tract 462.02, Morris County, New Jersey",0,0,0,0,0,0,0,1140,59,1199,950,634,3420,0,0,217,1297,98,1584,0
34027046297,0.9196141479099679,0.08038585209003216,20,0,1056,26,22,"Census Tract 462.97, Morris County, New Jersey",0,0,0,0,0,0,20,1107,37,1144,536,491,3560,20,9,67,1244,100,1027,29
34027046298,0.9324847814056447,0.06751521859435529,66,0.02877697841726619,1811,8,53,"Census Tract 462.98, Morris County, New Jersey",52,0,0,0,0,26,40,1570,115,1685,981,830,4769,0,0,377,1807,122,1811,0
34027046300,0.9619289340101523,0.03807106598984772,256,0,1989,79,151,"Census Tract 463, Morris County, New Jersey",0,100,43,29,53,8,23,1520,375,1895,1597,335,4673,20,37,942,1970,75,1932,57
34027046400,0.9722814498933902,0.02771855010660981,157,0,1420,101,89,"Census Tract 464, Morris County, New Jersey",0,25,10,0,51,38,33,1582,242,1824,761,578,4280,38,43,400,1876,52,1339,81
34029710100,0.6446520618556701,0.3553479381443299,645,0,1617,137,113,"Census Tract 7101, Ocean County, New Jersey",0,179,100,19,80,160,107,1455,546,2001,891,635,3398,58,33,1058,3104,1103,1526,91
34029711100,0.8490310950878774,0.1509689049121226,450,0,1376,80,100,"Census Tract 7111, Ocean County, New Jersey",0,108,172,10,11,44,105,1315,569,1884,750,574,3051,43,9,1070,2219,335,1324,52
34029711200,0.9281705948372615,0.0718294051627385,219,0,1564,64,16,"Census Tract 7112, Ocean County, New Jersey",0,61,66,25,16,11,40,1295,359,1654,1003,525,3646,22,14,1091,1782,128,1528,36
34029711300,0.8809255079006773,0.1190744920993228,116,0,1591,31,22,"Census Tract 7113, Ocean County, New Jersey",0,58,17,9,11,12,9,1318,243,1561,909,607,3360,66,9,621,1772,211,1516,75
34029711400,0.8518382352941176,0.14816176470588235,156,0,1926,58,36,"Census Tract 7114, Ocean County, New Jersey",0,0,0,0,19,78,59,1975,342,2317,1009,885,4795,0,32,785,2720,403,1894,32
34029712000,0.4290633608815427,0.5709366391184573,61,0.008953168044077135,572,14,23,"Census Tract 7120, Ocean County, New Jersey",13,7,0,0,11,4,39,532,91,623,307,222,1114,23,20,194,1452,829,529,43
34029713000,0.9464656964656964,0.05353430353430354,514,0,1743,142,8,"Census Tract 7130, Ocean County, New Jersey",0,195,90,110,49,36,34,1322,499,1821,926,767,3667,7,43,848,1924,103,1693,50
34029713100,0.9583645911477869,0.041635408852213056,183,0,2458,76,113,"Census Tract 7131, Ocean County, New Jersey",0,48,0,14,65,43,13,2290,265,2555,1273,1155,5779,30,0,549,2666,111,2428,30
34029713201,0.9089184060721063,0.09108159392789374,72,0,1103,15,11,"Census Tract 7132.01, Ocean County, New Jersey",0,5,0,0,26,22,19,886,72,958,690,413,2358,0,0,146,1054,96,1103,0
34029713202,0.9611716621253406,0.0388283378746594,87,0,1765,27,42,"Census Tract 7132.02, Ocean County, New Jersey",0,18,0,0,24,45,0,1259,152,1411,927,838,3470,0,0,606,1468,57,1765,0
34029713203,0.8909410729991205,0.1090589270008795,286,0.005277044854881266,1144,136,0,"Census Tract 7132.03, Ocean County, New Jersey",12,125,42,0,79,40,0,1644,382,2026,722,422,3664,0,0,1138,2274,248,1144,0
34029713300,0.8831227436823105,0.11687725631768953,236,0.00631768953068592,1467,184,36,"Census Tract 7133, Ocean County, New Jersey",14,0,0,75,132,29,0,1817,140,1957,1154,313,3611,0,0,195,2216,259,1467,0
34029713401,0.9328993490235353,0.0671006509764647,363,0,1428,87,72,"Census Tract 7134.01, Ocean County, New Jersey",0,86,58,149,47,0,23,1484,379,1863,762,658,4035,8,0,707,1997,134,1420,8
34029713402,0.8724489795918368,0.12755102040816327,655,0,1091,342,106,"Census Tract 7134.02, Ocean County, New Jersey",0,72,111,386,11,67,8,854,685,1539,482,521,2436,88,0,880,1764,225,1003,88
34029713500,0.9009265858873842,0.09907341411261582,19,0.042765502494654314,1233,42,0,"Census Tract 7135, Ocean County, New Jersey",60,0,0,0,0,8,11,1171,93,1264,880,353,2519,0,0,219,1403,139,1233,0
34029713600,0.8773656320968963,0.12263436790310371,0,0,1675,14,111,"Census Tract 7136, Ocean County, New Jersey",0,0,0,0,0,0,0,1121,38,1159,1058,617,3565,0,0,84,1321,162,1675,0
34029713700,0.8861538461538462,0.11384615384615385,0,0,1054,38,7,"Census Tract 7137, Ocean County, New Jersey",0,0,0,0,0,0,0,1045,107,1152,557,487,2345,0,10,262,1300,148,1044,10
34029713800,0.8123827392120075,0.18761726078799248,31,0.00375234521575985,1297,54,22,"Census Tract 7138, Ocean County, New Jersey",6,21,0,0,0,0,10,1008,291,1299,672,625,2424,0,0,973,1599,300,1297,0
34029713900,0.9356901090635578,0.06430989093644227,364,0.009778112072207596,1546,183,46,"Census Tract 7139, Ocean County, New Jersey",26,78,97,38,41,46,64,1883,605,2488,890,455,5489,66,135,1489,2659,171,1345,201
34029714000,0.9495967741935484,0.05040322580645161,176,0,2304,153,32,"Census Tract 7140, Ocean County, New Jersey",0,0,47,95,22,0,12,2109,246,2355,1086,1140,5680,45,33,706,2480,125,2226,78
34029714100,0.9448051948051948,0.05519480519480519,73,0,1249,187,7,"Census Tract 7141, Ocean County, New Jersey",0,13,29,0,0,0,31,1451,295,1746,736,513,2658,0,0,777,1848,102,1249,0
34029714200,0.9038909211839042,0.09610907881609577,585,0.005653475224476222,1897,27,106,"Census Tract 7142, Ocean County, New Jersey",17,171,275,56,0,15,68,1946,772,2718,1079,601,5280,193,24,1858,3007,289,1680,217
34029714300,0.7919501133786848,0.20804988662131518,0,0,1091,33,10,"Census Tract 7143, Ocean County, New Jersey",0,0,0,0,0,0,0,1254,143,1397,683,392,2866,0,16,378,1764,367,1075,16
34029714400,0.338006230529595,0.661993769470405,67,0.010124610591900311,482,26,33,"Census Tract 7144, Ocean County, New Jersey",13,0,0,46,0,0,21,401,33,434,140,342,730,0,0,92,1284,850,482,0
34029715000,0.9137600613261786,0.08623993867382139,915,0,428,134,184,"Census Tract 7150, Ocean County, New Jersey",0,67,146,185,256,250,11,930,1454,2384,195,222,3927,11,0,5924,2609,225,417,11
34029715200,0.9598842018196857,0.040115798180314306,780,0.006617038875103391,1837,459,18,"Census Tract 7152, Ocean County, New Jersey",16,150,66,222,181,48,113,639,1682,2321,626,103,3982,1064,44,8630,2418,97,729,1108
34029715301,0.9243697478991597,0.07563025210084033,468,0,1680,155,105,"Census Tract 7153.01, Ocean County, New Jersey",0,112,0,33,167,76,80,501,1259,1760,1129,172,2729,257,122,5758,1904,144,1301,379
34029715302,0.9251101321585903,0.07488986784140969,857,0,1191,225,27,"Census Tract 7153.02, Ocean County, New Jersey",0,110,253,298,64,20,112,122,1138,1260,363,43,798,757,28,5459,1362,102,406,785
34029715401,0.8820326678765881,0.11796733212341198,91,0,1600,45,30,"Census Tract 7154.01, Ocean County, New Jersey",0,0,28,0,20,0,43,656,316,972,1136,208,2969,190,66,2124,1102,130,1344,256
34029715402,0.9740973312401884,0.025902668759811617,751,0,1182,71,0,"Census Tract 7154.02, Ocean County, New Jersey",0,85,347,57,128,67,67,288,953,1241,719,131,1702,282,50,3977,1274,33,850,332
34029715500,0.8876811594202898,0.11231884057971014,346,0,2203,95,120,"Census Tract 7155, Ocean County, New Jersey",0,125,0,0,51,147,23,1407,798,2205,889,343,7765,971,0,5316,2484,279,1232,971
34029715600,0.9664804469273743,0.0335195530726257,343,0,1084,136,29,"Census Tract 7156, Ocean County, New Jersey",0,96,64,44,14,33,92,546,838,1384,542,166,3682,368,8,4435,1432,48,708,376
34029715700,0.8882126841768098,0.11178731582319026,642,0.008968609865470852,705,415,73,"Census Tract 7157, Ocean County, New Jersey",28,42,0,153,117,267,63,1734,1039,2773,402,303,6023,0,0,4664,3122,349,705,0
34029715800,0.9350490196078431,0.06495098039215687,304,0,531,51,41,"Census Tract 7158, Ocean County, New Jersey",0,32,28,36,87,68,53,816,710,1526,308,214,5155,9,0,3366,1632,106,522,9
34029715901,0.8706157443491817,0.1293842556508184,929,0,247,260,0,"Census Tract 7159.01, Ocean County, New Jersey",0,209,201,286,171,0,62,376,741,1117,83,164,753,0,0,1588,1283,166,247,0
34029715902,0.8784709700685178,0.12152902993148215,943,0,565,748,19,"Census Tract 7159.02, Ocean County, New Jersey",0,80,63,382,141,168,109,1415,1021,2436,273,165,2281,96,31,2016,2773,337,438,127
34029716000,0.8746498599439776,0.1253501400560224,182,0,1399,216,0,"Census Tract 7160, Ocean County, New Jersey",0,0,0,24,10,125,23,2194,304,2498,1271,117,3352,11,0,395,2856,358,1388,11
34029717001,0.9232386961093586,0.07676130389064142,5,0,1064,0,45,"Census Tract 7170.01, Ocean County, New Jersey",0,0,0,0,0,0,5,870,8,878,636,428,2920,0,0,51,951,73,1064,0
34029717002,0.9122516556291391,0.08774834437086093,827,0,1066,248,68,"Census Tract 7170.02, Ocean County, New Jersey",0,213,86,351,138,39,0,822,831,1653,587,400,2670,79,0,1959,1812,159,987,79
34029717101,0.9732368896925859,0.026763110307414104,351,0,3036,28,80,"Census Tract 7171.01, Ocean County, New Jersey",0,57,0,56,238,0,0,2354,337,2691,1981,1011,7738,44,0,770,2765,74,2992,44
34029717102,0.928605654048874,0.07139434595112602,152,0.06851940584571155,696,56,100,"Census Tract 7171.02, Ocean County, New Jersey",143,0,0,0,106,25,21,1785,153,1938,372,324,4211,0,0,474,2087,149,696,0
34029717200,0.949057714958775,0.05094228504122497,86,0.06065959952885748,3167,144,164,"Census Tract 7172, Ocean County, New Jersey",206,25,12,49,0,0,0,3029,194,3223,2286,795,8356,58,28,410,3396,173,3081,86
34029717300,0.9580310880829016,0.04196891191709844,66,0,1635,38,80,"Census Tract 7173, Ocean County, New Jersey",0,0,0,0,0,0,66,1728,121,1849,1229,377,5527,0,29,278,1930,81,1606,29
34029717400,0.8652575957727873,0.13474240422721268,55,0.28797886393659183,1647,21,66,"Census Tract 7174, Ocean County, New Jersey",654,0,0,0,0,18,37,1696,269,1965,1161,470,5161,16,0,689,2271,306,1631,16
34029717501,0.9549604382227632,0.04503956177723676,799,0,2232,151,46,"Census Tract 7175.01, Ocean County, New Jersey",0,92,120,75,115,325,72,2419,719,3138,1436,796,5895,0,0,1957,3286,148,2232,0
34029717502,0.9818121693121693,0.018187830687830687,282,0,1259,261,72,"Census Tract 7175.02, Ocean County, New Jersey",0,0,35,124,48,75,0,2620,349,2969,780,479,6416,0,0,880,3024,55,1259,0
34029718000,0.9878844361602982,0.012115563839701771,258,0.08574091332712022,3485,97,51,"Census Tract 7180, Ocean County, New Jersey",276,44,0,0,0,109,105,2650,530,3180,2005,1366,7348,20,94,1156,3219,39,3371,114
34029720001,0.8370927318295739,0.16290726817042606,486,0,1289,359,0,"Census Tract 7200.01, Ocean County, New Jersey",0,0,18,468,0,0,0,1634,370,2004,729,544,3750,0,16,478,2394,390,1273,16
34029720101,0.8529337698312768,0.14706623016872325,1049,0.16544950893981364,821,366,0,"Census Tract 7201.01, Ocean County, New Jersey",657,156,99,172,194,306,122,2559,828,3387,368,440,4582,13,0,1678,3971,584,808,13
34029720102,0.8914265635980323,0.10857343640196768,796,0.005621925509486999,801,535,15,"Census Tract 7201.02, Ocean County, New Jersey",16,0,14,263,143,241,135,1935,602,2537,508,293,2707,0,0,784,2846,309,801,0
34029720103,0.8895652173913043,0.11043478260869566,398,0.3660869565217391,802,386,0,"Census Tract 7201.03, Ocean County, New Jersey",1263,0,0,0,0,313,85,2902,167,3069,568,208,4377,26,0,253,3450,381,776,26
34029720202,0.9347037484885127,0.06529625151148731,658,0,725,179,0,"Census Tract 7202.02, Ocean County, New Jersey",0,0,0,0,31,613,14,1974,345,2319,571,124,3229,30,0,413,2481,162,695,30
34029720203,0.8804563492063492,0.1195436507936508,41,0.02132936507936508,1435,61,0,"Census Tract 7202.03, Ocean County, New Jersey",43,0,0,0,8,8,25,1661,114,1775,819,583,4019,0,33,190,2016,241,1402,33
34029720204,0.9403559403559404,0.059644059644059645,309,0,1837,162,0,"Census Tract 7202.04, Ocean County, New Jersey",0,65,9,80,129,18,8,1456,499,1955,948,827,4624,42,20,1063,2079,124,1775,62
34029720205,0.899009900990099,0.100990099009901,11,0,804,94,0,"Census Tract 7202.05, Ocean County, New Jersey",0,0,0,0,0,0,11,1723,93,1816,556,239,2876,9,0,127,2020,204,795,9
34029720206,0.9181614349775785,0.08183856502242152,512,0.02998878923766816,1595,87,11,"Census Tract 7202.06, Ocean County, New Jersey",107,0,0,0,0,376,136,3032,244,3276,1035,548,5666,12,0,445,3568,292,1583,12
34029721000,0.9295634920634921,0.07043650793650794,105,0.06646825396825397,696,65,21,"Census Tract 7210, Ocean County, New Jersey",67,6,0,0,12,53,34,615,322,937,244,452,1705,0,0,978,1008,71,696,0
34029722001,0.9488933601609658,0.051106639839034206,348,0,1247,194,49,"Census Tract 7220.01, Ocean County, New Jersey",0,67,0,30,180,50,21,2052,306,2358,1081,133,4390,33,0,805,2485,127,1214,33
34029722002,0.9799484388427385,0.02005156115726153,250,0.35491263248352906,2508,294,72,"Census Tract 7220.02, Ocean County, New Jersey",1239,109,0,91,50,0,0,3006,415,3421,1742,766,7457,0,0,953,3491,70,2508,0
34029722100,0.9029957203994294,0.09700427960057062,150,0,1808,304,0,"Census Tract 7221, Ocean County, New Jersey",0,10,0,97,0,43,0,2294,238,2532,1032,720,5079,43,13,445,2804,272,1752,56
34029722200,0.898175397292525,0.10182460270747498,25,0,777,203,13,"Census Tract 7222, Ocean County, New Jersey",0,0,0,0,0,12,13,1265,261,1526,565,153,1927,0,59,459,1699,173,718,59
34029722300,0.9622071050642479,0.03779289493575208,34,0,1373,64,0,"Census Tract 7223, Ocean County, New Jersey",0,0,0,0,34,0,0,1200,73,1273,720,653,3422,0,0,385,1323,50,1373,0
34029722401,0.8671943711521548,0.13280562884784522,161,0,1596,81,18,"Census Tract 7224.01, Ocean County, New Jersey",0,54,0,0,97,10,0,1661,311,1972,900,696,4436,0,0,893,2274,302,1596,0
34029722402,0.8192026951151039,0.18079730488489612,240,0,1309,50,34,"Census Tract 7224.02, Ocean County, New Jersey",0,93,7,58,72,10,0,1225,234,1459,704,605,3194,0,0,601,1781,322,1309,0
34029722500,0.23821921374642022,0.7617807862535798,144,0.003384535277271544,624,65,14,"Census Tract 7225, Ocean County, New Jersey",13,49,5,0,59,0,31,854,61,915,172,452,1622,0,0,91,3841,2926,624,0
34029722600,0.8110850897736144,0.18891491022638562,8,0.00624512099921936,992,11,0,"Census Tract 7226, Ocean County, New Jersey",8,0,0,0,8,0,0,965,74,1039,376,616,2694,0,0,197,1281,242,992,0
34029722701,0.9939759036144579,0.006024096385542169,88,0,2201,72,50,"Census Tract 7227.01, Ocean County, New Jersey",0,0,0,88,0,0,0,1533,117,1650,1287,914,4729,0,0,147,1660,10,2201,0
34029722702,0.8813447593935398,0.11865524060646011,12,0,1929,14,9,"Census Tract 7227.02, Ocean County, New Jersey",0,0,0,0,0,12,0,1172,165,1337,751,888,3404,272,18,620,1517,180,1639,290
34029722800,0.9696969696969697,0.030303030303030304,796,0,1291,159,120,"Census Tract 7228, Ocean County, New Jersey",0,269,78,73,198,117,61,1080,712,1792,951,320,2793,0,20,1718,1848,56,1271,20
34029722900,0.9592592592592593,0.040740740740740744,1116,0,1037,150,64,"Census Tract 7229, Ocean County, New Jersey",0,239,211,114,389,141,22,894,1178,2072,583,421,2641,22,11,2732,2160,88,1004,33
34029723000,0.9727758872143899,0.027224112785610113,374,0.025279533300923675,2221,109,51,"Census Tract 7230, Ocean County, New Jersey",52,115,63,23,157,12,4,1475,526,2001,1026,1126,4522,59,10,1305,2057,56,2152,69
34029723100,0.8917311124330756,0.10826888756692445,461,0,1490,189,39,"Census Tract 7231, Ocean County, New Jersey",0,74,44,130,65,85,63,1019,480,1499,692,715,2592,83,0,1045,1681,182,1407,83
34029723200,0.9727058823529412,0.027294117647058823,62,0,2504,114,79,"Census Tract 7232, Ocean County, New Jersey",0,12,0,0,0,0,50,1904,163,2067,1169,1306,5676,29,0,620,2125,58,2475,29
34029723300,0.9650040225261464,0.03499597747385358,198,0,2061,111,19,"Census Tract 7233, Ocean County, New Jersey",0,0,0,15,166,17,0,1711,688,2399,1301,554,4765,69,137,2482,2486,87,1855,206
34029723400,0.7164584464964693,0.28354155350353066,75,0,1051,40,0,"Census Tract 7234, Ocean County, New Jersey",0,25,0,0,0,0,50,1153,166,1319,430,503,2840,118,0,438,1841,522,933,118
34029723500,0.6886314265025344,0.3113685734974656,17,0.0166545981173063,560,21,0,"Census Tract 7235, Ocean County, New Jersey",23,0,0,0,0,0,17,743,208,951,320,240,1617,0,0,670,1381,430,560,0
34029723600,0.875,0.125,121,0.011363636363636364,725,42,24,"Census Tract 7236, Ocean County, New Jersey",12,27,44,8,11,27,4,738,186,924,393,327,1858,5,0,467,1056,132,720,5
34029724000,0.8986425339366516,0.10135746606334842,46,0.004524886877828055,1057,26,36,"Census Tract 7240, Ocean County, New Jersey",5,0,4,0,38,4,0,757,236,993,395,649,2593,0,13,1155,1105,112,1044,13
34029725001,0.9489795918367347,0.05102040816326531,28,0.00463821892393321,1373,33,7,"Census Tract 7250.01, Ocean County, New Jersey",5,0,0,0,0,28,0,876,147,1023,495,829,2629,49,0,484,1078,55,1324,49
34029725002,0.9620622568093385,0.037937743190661476,27,0,2833,43,18,"Census Tract 7250.02, Ocean County, New Jersey",0,0,0,0,13,0,14,1706,272,1978,1776,990,5156,44,23,775,2056,78,2766,67
34029725100,0.9139784946236559,0.08602150537634409,36,0,604,18,6,"Census Tract 7251, Ocean County, New Jersey",0,0,8,0,0,16,12,580,185,765,215,389,1504,0,0,643,837,72,604,0
34029726000,0.8134715025906736,0.18652849740932642,31,0,727,11,5,"Census Tract 7260, Ocean County, New Jersey",0,7,0,0,0,14,10,516,112,628,372,334,1195,21,0,262,772,144,706,21
34029727001,0.361961171437973,0.638038828562027,693,0.004606778545574202,836,35,5,"Census Tract 7270.01, Ocean County, New Jersey",14,126,0,0,112,106,349,946,154,1100,388,443,1853,5,0,308,3039,1939,831,5
34029727002,0.28404344193817876,0.7159565580618212,648,0,330,32,9,"Census Tract 7270.02, Ocean County, New Jersey",0,85,233,4,61,94,171,592,88,680,101,224,1158,0,5,123,2394,1714,325,5
34029728000,0.34107545045045046,0.6589245495495496,2628,0.019707207207207207,1133,284,134,"Census Tract 7280, Ocean County, New Jersey",140,193,113,118,773,602,829,1312,1111,2423,426,669,2484,38,0,2813,7104,4681,1095,38
34029729000,0.6212624584717608,0.3787375415282392,185,0,371,47,0,"Census Tract 7290, Ocean County, New Jersey",0,0,0,6,24,15,140,507,241,748,175,187,1098,9,0,635,1204,456,362,9
34029730000,0.8947939262472885,0.1052060737527115,32,0,1078,13,24,"Census Tract 7300, Ocean County, New Jersey",0,0,0,14,0,0,18,764,61,825,709,369,2067,0,0,169,922,97,1078,0
34029731001,0.7549778761061947,0.24502212389380532,122,0,1389,16,30,"Census Tract 7310.01, Ocean County, New Jersey",0,33,0,7,23,59,0,1278,87,1365,762,627,2965,0,0,124,1808,443,1389,0
34029731002,0.8348240906380441,0.16517590936195586,26,0,1257,33,42,"Census Tract 7310.02, Ocean County, New Jersey",0,0,0,0,12,14,0,1170,230,1400,486,718,3047,53,0,564,1677,277,1204,53
34029731101,0.9179528838342811,0.08204711616571893,255,0.007311129163281885,818,55,25,"Census Tract 7311.01, Ocean County, New Jersey",9,60,0,16,122,46,11,775,355,1130,416,389,2266,0,13,1069,1231,101,805,13
34029731102,0.9641532756489494,0.03584672435105068,430,0,1709,203,15,"Census Tract 7311.02, Ocean County, New Jersey",0,188,89,32,67,16,38,1717,623,2340,673,969,4936,67,0,1560,2427,87,1642,67
34029731103,0.954834156669019,0.04516584333098095,0,0,1141,0,48,"Census Tract 7311.03, Ocean County, New Jersey",0,0,0,0,0,0,0,1285,68,1353,597,539,4017,0,5,268,1417,64,1136,5
34029731201,0.8844237794752574,0.1155762205247426,18,0,918,192,56,"Census Tract 7312.01, Ocean County, New Jersey",0,0,0,9,0,0,9,2400,263,2663,643,275,3961,0,0,435,3011,348,918,0
34029731202,0.863971767725377,0.13602823227462305,33,0.005133140840551813,1244,379,10,"Census Tract 7312.02, Ocean County, New Jersey",16,0,0,0,15,0,18,2584,109,2693,881,363,4001,0,0,172,3117,424,1244,0
34029731203,0.8104524180967239,0.18954758190327614,33,0,460,93,0,"Census Tract 7312.03, Ocean County, New Jersey",0,0,0,25,0,8,0,943,96,1039,248,212,1551,0,0,189,1282,243,460,0
34029731204,0.8860494344365312,0.11395056556346879,0,0.025555090071219103,1107,255,16,"Census Tract 7312.04, Ocean County, New Jersey",61,0,0,0,0,0,0,1953,162,2115,812,263,3220,32,0,321,2387,272,1075,32
34029731205,0.930310262529833,0.06968973747016706,0,0,651,130,0,"Census Tract 7312.05, Ocean County, New Jersey",0,0,0,0,0,0,0,1722,227,1949,433,194,3011,15,9,454,2095,146,627,24
34029731206,0.8041172800998129,0.19588271990018716,51,0.0056144728633811605,398,110,0,"Census Tract 7312.06, Ocean County, New Jersey",9,0,0,0,0,0,51,1026,263,1289,192,170,1522,17,19,628,1603,314,362,36
34029732001,0.9542222222222222,0.04577777777777778,22,0,2311,0,44,"Census Tract 7320.01, Ocean County, New Jersey",0,22,0,0,0,0,0,2075,72,2147,1272,1039,6216,0,0,138,2250,103,2311,0
34029732002,0.9084637834969488,0.0915362165030512,95,0,2233,152,37,"Census Tract 7320.02, Ocean County, New Jersey",0,16,0,48,0,0,31,3093,331,3424,1012,1221,8171,0,0,939,3769,345,2233,0
34029732101,0.9096551724137931,0.09034482758620689,220,0,2656,209,65,"Census Tract 7321.01, Ocean County, New Jersey",0,0,56,141,0,0,23,2213,425,2638,1435,1185,5739,0,36,954,2900,262,2620,36
34029732103,0.7531468531468531,0.24685314685314685,60,0,762,24,0,"Census Tract 7321.03, Ocean County, New Jersey",0,13,0,0,0,10,37,969,108,1077,390,352,2153,11,9,280,1430,353,742,20
34029732104,0.7431192660550459,0.25688073394495414,12,0,1420,40,20,"Census Tract 7321.04, Ocean County, New Jersey",0,0,0,0,0,0,12,1411,290,1701,747,673,3145,0,0,795,2289,588,1420,0
34029733000,0.869167030091583,0.13083296990841692,183,0,2034,119,57,"Census Tract 7330, Ocean County, New Jersey",0,14,0,72,63,34,0,3408,578,3986,1156,846,7514,17,15,1406,4586,600,2002,32
34029734001,0.9262796963017389,0.07372030369826109,0,0.1266225814352192,902,54,50,"Census Tract 7340.01, Ocean County, New Jersey",517,0,0,0,0,0,0,3613,169,3782,617,260,7789,25,0,282,4083,301,877,25
34029734002,0.8288659793814434,0.1711340206185567,625,0,1714,121,64,"Census Tract 7340.02, Ocean County, New Jersey",0,66,14,41,217,190,97,1800,612,2412,1377,337,4930,0,0,1600,2910,498,1714,0
34029734003,0.8651059085841695,0.13489409141583056,104,0,2019,155,39,"Census Tract 7340.03, Ocean County, New Jersey",0,0,0,5,87,12,0,2027,301,2328,1190,829,6542,0,0,1151,2691,363,2019,0
34029735001,0.9253840526700805,0.07461594732991954,112,0,2079,44,24,"Census Tract 7350.01, Ocean County, New Jersey",0,0,0,0,14,31,67,2256,274,2530,1532,476,6074,57,14,888,2734,204,2008,71
34029735002,0.9178430265386787,0.08215697346132128,380,0,2971,104,25,"Census Tract 7350.02, Ocean County, New Jersey",0,153,0,91,77,0,59,2689,562,3251,2150,821,7845,0,0,1280,3542,291,2971,0
34029735101,0.8573643410852713,0.14263565891472868,124,0.2302325581395349,605,102,18,"Census Tract 7351.01, Ocean County, New Jersey",297,15,8,10,38,18,35,962,144,1106,485,120,2270,0,0,393,1290,184,605,0
34029735103,0.3987902354720242,0.6012097645279758,33,0,1604,59,65,"Census Tract 7351.03, Ocean County, New Jersey",0,0,0,0,0,0,33,1525,321,1846,550,692,3224,60,302,898,4629,2783,1242,362
34029735104,0.8837465564738292,0.1162534435261708,167,0.08980716253443526,907,168,47,"Census Tract 7351.04, Ocean County, New Jersey",163,0,0,61,12,38,56,1267,337,1604,581,294,3344,9,23,624,1815,211,875,32
34029736001,0.9513888888888888,0.04861111111111111,64,0,642,118,10,"Census Tract 7360.01, Ocean County, New Jersey",0,0,0,0,0,64,0,1434,73,1507,415,227,3287,0,0,235,1584,77,642,0
34029736002,0.7737789203084833,0.2262210796915167,6,0.02056555269922879,592,20,28,"Census Tract 7360.02, Ocean County, New Jersey",16,0,0,0,3,0,3,520,82,602,237,336,1387,16,3,210,778,176,573,19
34029736101,0.9488768396591789,0.05112316034082107,76,0,1193,107,0,"Census Tract 7361.01, Ocean County, New Jersey",0,0,0,76,0,0,0,2174,276,2450,683,510,5254,0,0,631,2582,132,1193,0
34029736102,0.8396023643202579,0.16039763567974208,446,0.01155292853304675,1682,128,101,"Census Tract 7361.02, Ocean County, New Jersey",43,148,41,16,118,56,67,2436,689,3125,1219,449,5811,14,0,1674,3722,597,1668,14
34029736105,0.5331944030961596,0.46680559690384044,21,0,822,95,22,"Census Tract 7361.05, Ocean County, New Jersey",0,0,0,11,0,0,10,1497,294,1791,508,286,2907,19,9,790,3359,1568,794,28
34029737000,0.7367617107942973,0.26323828920570264,231,0.050407331975560084,1141,84,10,"Census Tract 7370, Ocean County, New Jersey",99,0,69,39,79,0,44,1099,348,1447,758,383,2634,0,0,735,1964,517,1141,0
34029738001,0.190609095386636,0.8093909046133639,1112,0.0037760630438351665,898,35,40,"Census Tract 7380.01, Ocean County, New Jersey",23,24,0,31,54,153,850,1028,133,1161,445,403,1827,35,15,234,6091,4930,848,50
34029738002,0.1867618786047789,0.8132381213952211,996,0.032134029112881074,598,48,0,"Census Tract 7380.02, Ocean County, New Jersey",117,181,195,10,53,139,418,606,74,680,303,288,1172,0,7,139,3641,2961,591,7
34029738100,0.19579139981701738,0.8042086001829826,439,9.149130832570906e-4,828,43,30,"Census Tract 7381, Ocean County, New Jersey",4,22,76,0,32,26,283,815,41,856,405,416,1566,7,0,53,4372,3516,821,7
34029739000,0.2364804964539007,0.7635195035460993,837,0,969,46,13,"Census Tract 7390, Ocean County, New Jersey",0,32,21,23,24,106,631,903,164,1067,499,426,1922,12,32,337,4512,3445,925,44
34029739100,0.88203125,0.11796875,149,0,278,168,0,"Census Tract 7391, Ocean County, New Jersey",0,0,0,11,0,0,138,1083,46,1129,212,48,1498,18,0,64,1280,151,260,18
34029980000,NaN,NaN,0,NaN,0,0,0,"Census Tract 9800, Ocean County, New Jersey",0,0,0,0,0,0,0,0,0,0,0,0,0,0,0,0,0,0,0,0
34029980100,0,1,0,0,0,0,0,"Census Tract 9801, Ocean County, New Jersey",0,0,0,0,0,0,0,0,0,0,0,0,0,0,0,0,13,13,0,0
34029990000,NaN,NaN,0,NaN,0,0,0,"Census Tract 9900, Ocean County, New Jersey",0,0,0,0,0,0,0,0,0,0,0,0,0,0,0,0,0,0,0,0
34031116500,0.9579500657030223,0.04204993429697766,887,0,2465,158,78,"Census Tract 1165, Passaic County, New Jersey",0,180,71,237,136,65,198,1925,991,2916,1184,1198,5252,62,21,2742,3044,128,2382,83
34031124200,0.9138702460850112,0.08612975391498881,701,0,2298,55,378,"Census Tract 1242, Passaic County, New Jersey",0,0,93,0,0,85,523,1827,624,2451,1261,957,5874,0,80,1780,2682,231,2218,80
34031124311,0.9304783092324805,0.06952169076751946,187,0,1985,76,108,"Census Tract 1243.11, Passaic County, New Jersey",0,31,9,9,19,17,102,1427,246,1673,977,946,4111,27,35,571,1798,125,1923,62
34031124312,0.9622878692646134,0.03771213073538655,366,0,1503,91,306,"Census Tract 1243.12, Passaic County, New Jersey",0,189,65,26,50,36,0,1318,213,1531,870,619,3292,14,0,425,1591,60,1489,14
34031124321,0.9009864815491414,0.09901351845085861,1191,0,1651,170,507,"Census Tract 1243.21, Passaic County, New Jersey",0,155,236,184,56,392,168,1754,712,2466,830,773,4692,32,16,1493,2737,271,1603,48
34031124322,0.9363380281690141,0.06366197183098592,361,0,1182,124,319,"Census Tract 1243.22, Passaic County, New Jersey",0,0,38,34,116,156,17,1260,402,1662,617,508,3554,28,29,888,1775,113,1125,57
34031124323,0.9830618892508143,0.016938110749185668,1168,0,614,204,201,"Census Tract 1243.23, Passaic County, New Jersey",0,45,67,365,82,531,78,243,1266,1509,123,121,637,241,129,2472,1535,26,244,370
34031124401,0.9262908947575877,0.0737091052424123,1264,0,1579,222,506,"Census Tract 1244.01, Passaic County, New Jersey",0,14,0,26,75,362,787,1511,839,2350,504,914,5634,108,53,2013,2537,187,1418,161
34031124402,0.9144927536231884,0.08550724637681159,632,0,1529,66,384,"Census Tract 1244.02, Passaic County, New Jersey",0,31,18,0,155,51,377,1457,436,1893,644,835,3804,32,18,1307,2070,177,1479,50
34031124500,0.8670812281383599,0.1329187718616401,1721,0,1528,406,222,"Census Tract 1245, Passaic County, New Jersey",0,46,17,476,135,243,804,1028,1203,2231,707,670,3353,64,87,2060,2573,342,1377,151
34031124601,0.9512345679012346,0.04876543209876543,1063,0,1217,278,209,"Census Tract 1246.01, Passaic County, New Jersey",0,36,96,223,14,130,564,755,786,1541,409,537,2594,188,83,2050,1620,79,946,271
34031124602,0.9087003222341569,0.09129967776584318,929,0.012352309344790547,991,122,127,"Census Tract 1246.02, Passaic County, New Jersey",23,138,85,140,199,134,233,791,901,1692,332,442,2306,154,63,2560,1862,170,774,217
34031124700,0.8434365460095944,0.15656345399040558,991,0.005233318796336677,2169,98,382,"Census Tract 1247, Passaic County, New Jersey",12,6,11,0,41,58,875,1274,660,1934,1004,751,4229,342,72,1953,2293,359,1755,414
34031124800,0.9645569620253165,0.035443037974683546,922,0,1111,163,239,"Census Tract 1248, Passaic County, New Jersey",0,38,39,0,51,67,727,896,628,1524,546,465,2833,35,65,1861,1580,56,1011,100
34031124900,0.9491417673235855,0.0508582326764145,1100,0,1290,190,367,"Census Tract 1249, Passaic County, New Jersey",0,44,11,0,43,134,868,544,949,1493,377,314,1751,473,126,3456,1573,80,691,599
34031125000,0.9051763628034815,0.09482363719651855,1722,0,1282,321,295,"Census Tract 1250, Passaic County, New Jersey",0,23,43,19,82,137,1418,801,1175,1976,561,419,2685,292,10,4446,2183,207,980,302
34031125100,0.9159911569638909,0.08400884303610906,1189,0,800,323,145,"Census Tract 1251, Passaic County, New Jersey",0,214,48,0,166,127,634,289,954,1243,408,164,890,98,130,2882,1357,114,572,228
34031133701,1,0,1098,0,1042,174,325,"Census Tract 1337.01, Passaic County, New Jersey",0,17,48,0,6,261,766,750,941,1691,646,264,2294,57,75,2846,1691,0,910,132
34031133702,0.9389799635701275,0.0610200364298725,705,0,668,109,76,"Census Tract 1337.02, Passaic County, New Jersey",0,22,78,151,19,134,301,501,530,1031,251,210,1632,81,126,1533,1098,67,461,207
34031143200,0.9776089564174331,0.022391043582566973,613,0,2168,65,138,"Census Tract 1432, Passaic County, New Jersey",0,102,44,100,0,66,301,1834,611,2445,876,1223,5234,69,0,1231,2501,56,2099,69
34031143300,0.9720594862550699,0.02794051374493015,1175,0,1818,110,159,"Census Tract 1433, Passaic County, New Jersey",0,13,86,0,35,43,998,1148,1009,2157,637,728,3305,132,321,2280,2219,62,1365,453
34031143400,0.968019680196802,0.03198031980319803,1603,0,1256,131,150,"Census Tract 1434, Passaic County, New Jersey",0,134,96,52,101,43,1177,1222,1139,2361,504,679,3793,19,54,2930,2439,78,1183,73
34031154001,0.975191700496166,0.02480829950383401,945,0,1649,60,170,"Census Tract 1540.01, Passaic County, New Jersey",0,347,144,79,182,156,37,1580,582,2162,803,821,3987,25,0,1117,2217,55,1624,25
34031154002,0.9448082319925164,0.05519176800748363,1156,0,2532,279,374,"Census Tract 1540.02, Passaic County, New Jersey",0,69,64,266,197,33,527,1919,1111,3030,1116,1094,5459,141,181,2820,3207,177,2210,322
34031163500,0.9739945570003024,0.02600544299969761,199,0,3041,180,86,"Census Tract 1635, Passaic County, New Jersey",0,0,0,0,28,0,171,2965,256,3221,1277,1666,7739,0,98,630,3307,86,2943,98
34031175200,0.9490322580645161,0.05096774193548387,1550,0,250,774,328,"Census Tract 1752, Passaic County, New Jersey",0,499,35,18,624,211,163,26,1445,1471,25,0,64,153,72,4959,1550,79,25,225
34031175301,0.9215086646279307,0.07849133537206932,947,0,457,482,275,"Census Tract 1753.01, Passaic County, New Jersey",0,61,15,6,355,252,258,81,823,904,93,65,398,197,102,3149,981,77,158,299
34031175302,0.9310820124052378,0.06891798759476224,1361,0,959,580,292,"Census Tract 1753.02, Passaic County, New Jersey",0,267,32,16,481,227,338,119,1232,1351,127,208,382,481,143,4412,1451,100,335,624
34031175401,0.9187725631768953,0.0812274368231047,1427,0,694,513,308,"Census Tract 1754.01, Passaic County, New Jersey",0,90,104,71,335,133,694,331,1196,1527,292,161,1123,86,155,4294,1662,135,453,241
34031175402,0.9155313351498637,0.08446866485013624,1385,0,1192,575,292,"Census Tract 1754.02, Passaic County, New Jersey",0,129,145,330,207,174,400,150,1194,1344,0,270,814,743,179,4396,1468,124,270,922
34031175500,0.9150141643059491,0.08498583569405099,1704,0.015108593012275733,1100,632,471,"Census Tract 1755, Passaic County, New Jersey",32,106,30,32,298,280,958,477,1461,1938,134,285,1651,634,47,5663,2118,180,419,681
34031175601,0.8863636363636364,0.11363636363636363,102,0.025974025974025976,645,21,120,"Census Tract 1756.01, Passaic County, New Jersey",16,0,45,0,11,0,46,485,61,546,347,291,2262,0,7,229,616,70,638,7
34031175602,0.9298959746720941,0.070104025327905925,1729,0,1132,508,348,"Census Tract 1756.02, Passaic County, New Jersey",0,390,118,75,151,109,886,832,1224,2056,446,354,2316,233,99,4548,2211,155,800,332
34031175701,0.9128678592036931,0.08713214079630698,1178,0,1314,290,299,"Census Tract 1757.01, Passaic County, New Jersey",0,75,164,202,77,181,479,600,982,1582,809,331,2479,123,51,2943,1733,151,1140,174
34031175703,0.8705281090289608,0.12947189097103917,1492,0,1140,401,389,"Census Tract 1757.03, Passaic County, New Jersey",0,271,278,488,58,114,283,520,1013,1533,627,116,1504,298,99,2923,1761,228,743,397
34031175704,0.9203539823008849,0.07964601769911504,899,0,1061,198,289,"Census Tract 1757.04, Passaic County, New Jersey",0,37,235,177,205,88,157,583,665,1248,409,452,2140,193,7,1896,1356,108,861,200
34031175801,0.9343575418994413,0.06564245810055866,1327,0,1028,455,311,"Census Tract 1758.01, Passaic County, New Jersey",0,118,518,280,138,99,174,151,1187,1338,145,223,516,502,158,3794,1432,94,368,660
34031175802,0.8825347758887172,0.11746522411128284,1776,0,271,803,332,"Census Tract 1758.02, Passaic County, New Jersey",0,368,135,68,519,216,470,76,1637,1713,0,16,369,242,13,6604,1941,228,16,255
34031175900,0.863564668769716,0.13643533123028392,1187,0,285,445,259,"Census Tract 1759, Passaic County, New Jersey",0,191,26,16,413,334,207,54,1041,1095,0,90,161,151,44,3750,1268,173,90,195
34031180100,0.9433487201007134,0.056651279899286616,908,0,1486,209,198,"Census Tract 1801, Passaic County, New Jersey",0,0,45,0,70,79,714,1379,869,2248,730,660,5129,83,13,2982,2383,135,1390,96
34031180201,0.880443388756928,0.11955661124307206,855,0,831,88,96,"Census Tract 1802.01, Passaic County, New Jersey",0,72,51,96,236,149,251,380,732,1112,267,174,1760,289,101,2142,1263,151,441,390
34031180202,0.9221649484536083,0.07783505154639175,1675,0,904,621,334,"Census Tract 1802.02, Passaic County, New Jersey",0,7,22,0,60,627,959,514,1275,1789,431,209,2421,83,181,4732,1940,151,640,264
34031180300,0.8504495977283483,0.14955040227165167,1825,0.012778040700425935,704,755,261,"Census Tract 1803, Passaic County, New Jersey",27,119,109,65,110,601,821,418,1379,1797,263,123,1291,277,41,4377,2113,316,386,318
34031180600,0.8810457516339869,0.11895424836601307,1209,0,839,316,275,"Census Tract 1806, Passaic County, New Jersey",0,0,0,0,39,337,833,445,903,1348,273,483,1679,30,53,3237,1530,182,756,83
34031180700,0.8319672131147541,0.1680327868852459,812,0,399,261,101,"Census Tract 1807, Passaic County, New Jersey",0,0,0,0,31,166,615,189,623,812,183,116,509,29,71,2197,976,164,299,100
34031180800,0.8988195615514334,0.10118043844856661,1059,0.011804384485666104,436,478,130,"Census Tract 1808, Passaic County, New Jersey",14,5,38,264,79,316,357,216,850,1066,228,92,760,86,30,2456,1186,120,320,116
34031180900,0.9052013422818792,0.09479865771812081,1005,0,843,261,258,"Census Tract 1809, Passaic County, New Jersey",0,43,0,19,81,320,542,217,862,1079,376,193,785,129,145,3137,1192,113,569,274
34031181000,0.922890103217972,0.07710989678202793,1396,0,518,364,107,"Census Tract 1810, Passaic County, New Jersey",0,59,0,12,154,494,677,420,1100,1520,218,45,1583,126,129,3003,1647,127,263,255
34031181100,0.8997722095671982,0.10022779043280182,1582,0,1756,328,258,"Census Tract 1811, Passaic County, New Jersey",0,112,53,68,243,343,763,736,1239,1975,98,1095,2842,273,290,4014,2195,220,1193,563
34031181200,0.9252275682704811,0.07477243172951886,1374,0,902,377,233,"Census Tract 1812, Passaic County, New Jersey",0,83,65,94,212,290,630,289,1134,1423,185,245,1015,217,255,3790,1538,115,430,472
34031181300,0.9063613231552163,0.09363867684478372,1661,0,503,643,215,"Census Tract 1813, Passaic County, New Jersey",0,52,235,376,55,421,522,243,1538,1781,229,122,840,107,45,4216,1965,184,351,152
34031181400,0.8377160030052592,0.1622839969947408,1277,0,134,675,170,"Census Tract 1814, Passaic County, New Jersey",0,94,119,259,121,203,481,104,1011,1115,0,99,317,11,24,2619,1331,216,99,35
34031181500,0.8508845829823083,0.14911541701769165,1061,0,284,456,137,"Census Tract 1815, Passaic County, New Jersey",0,73,142,0,117,326,403,146,864,1010,9,30,407,205,40,2841,1187,177,39,245
34031181702,0.7949152542372881,0.20508474576271185,1082,0,167,501,149,"Census Tract 1817.02, Passaic County, New Jersey",0,179,89,108,243,226,237,64,874,938,0,37,181,93,37,2335,1180,242,37,130
34031181800,0.8609523809523809,0.13904761904761906,1006,0,236,532,182,"Census Tract 1818, Passaic County, New Jersey",0,27,139,289,182,250,119,44,860,904,0,63,152,100,73,1992,1050,146,63,173
34031181900,0.9160437032777459,0.08395629672225417,1443,0,1177,240,131,"Census Tract 1819, Passaic County, New Jersey",0,91,0,25,256,280,791,712,881,1593,851,183,2076,143,0,2364,1739,146,1034,143
34031182000,0.9411764705882353,0.058823529411764705,469,0,163,271,58,"Census Tract 1820, Passaic County, New Jersey",0,10,11,17,44,240,147,60,420,480,49,81,250,33,0,1448,510,30,130,33
34031182100,0.8569194683346364,0.14308053166536355,1071,0,738,330,162,"Census Tract 1821, Passaic County, New Jersey",0,57,33,176,31,389,385,306,790,1096,393,281,1209,17,47,2236,1279,183,674,64
34031182200,0.8565776458951533,0.1434223541048467,923,0,210,479,205,"Census Tract 1822, Passaic County, New Jersey",0,33,85,77,120,186,422,55,811,866,66,63,207,81,0,2475,1011,145,129,81
34031182301,0.8458574181117534,0.15414258188824662,483,0,232,129,13,"Census Tract 1823.01, Passaic County, New Jersey",0,29,0,0,36,186,232,95,344,439,119,43,330,13,57,1147,519,80,162,70
34031182302,0.8871134020618556,0.11288659793814433,1818,0,857,779,142,"Census Tract 1823.02, Passaic County, New Jersey",0,98,38,115,141,791,635,211,1510,1721,161,296,838,316,84,4972,1940,219,457,400
34031182400,0.8948060486522025,0.1051939513477975,1205,0,1181,388,152,"Census Tract 1824, Passaic County, New Jersey",0,56,34,15,40,377,683,351,1010,1361,338,454,1466,302,87,3489,1521,160,792,389
34031182500,0.9197158081705151,0.0802841918294849,2197,0,1638,750,261,"Census Tract 1825, Passaic County, New Jersey",0,226,376,428,118,378,671,983,1606,2589,787,447,3676,141,263,3670,2815,226,1234,404
34031182600,0.9245689655172413,0.07543103448275862,1210,0,1543,291,273,"Census Tract 1826, Passaic County, New Jersey",0,148,132,0,79,169,682,751,965,1716,699,374,2180,319,151,2908,1856,140,1073,470
34031182700,0.9115678776290631,0.08843212237093691,1665,0,2168,522,224,"Census Tract 1827, Passaic County, New Jersey",0,65,26,12,126,340,1096,572,1335,1907,674,516,2107,844,134,4662,2092,185,1190,978
34031182800,0.9451783355350066,0.0548216644649934,1383,0,533,561,16,"Census Tract 1828, Passaic County, New Jersey",0,8,76,526,67,343,363,228,1203,1431,109,291,757,63,70,3005,1514,83,400,133
34031182900,0.8375558867362146,0.16244411326378538,553,0,94,281,189,"Census Tract 1829, Passaic County, New Jersey",0,88,38,17,61,120,229,66,496,562,7,41,190,46,0,1999,671,109,48,46
34031183000,0.9552511415525115,0.04474885844748858,1882,0,663,634,280,"Census Tract 1830, Passaic County, New Jersey",0,166,35,192,140,585,764,440,1652,2092,325,86,1864,180,72,5297,2190,98,411,252
34031183101,0.9827760891590679,0.017223910840932118,650,0,1051,77,51,"Census Tract 1831.01, Passaic County, New Jersey",0,15,22,71,17,46,479,394,576,970,461,280,1432,284,26,1574,987,17,741,310
34031183102,0.9424809424809425,0.05751905751905752,949,0,999,249,75,"Census Tract 1831.02, Passaic County, New Jersey",0,24,74,10,19,244,578,563,797,1360,413,336,2059,48,202,2929,1443,83,749,250
34031183200,0.9271623672230652,0.07283763277693475,1302,0,540,687,216,"Census Tract 1832, Passaic County, New Jersey",0,206,254,485,186,75,96,31,1191,1222,0,59,130,126,355,2509,1318,96,59,481
34031196401,0.9651702786377709,0.0348297213622291,34,0,1924,33,84,"Census Tract 1964.01, Passaic County, New Jersey",0,0,0,0,0,0,34,1153,94,1247,994,704,3712,9,217,433,1292,45,1698,226
34031196402,0.9551553672316384,0.044844632768361585,1227,0,2121,329,306,"Census Tract 1964.02, Passaic County, New Jersey",0,124,308,104,72,167,452,1711,994,2705,966,1056,4475,67,32,2404,2832,127,2022,99
34031203600,0.8949695964621338,0.10503040353786622,1277,0,1334,265,255,"Census Tract 2036, Passaic County, New Jersey",0,0,7,0,31,177,1062,702,917,1619,433,632,2751,269,0,3102,1809,190,1065,269
34031216701,0.8883139284174213,0.11168607158257869,3,0,2960,29,131,"Census Tract 2167.01, Passaic County, New Jersey",0,0,0,0,0,0,3,2000,60,2060,1619,1244,6341,26,71,193,2319,259,2863,97
34031216702,0.9645177411294353,0.03548225887056472,59,0,2110,19,86,"Census Tract 2167.02, Passaic County, New Jersey",0,0,12,0,0,0,47,1806,124,1930,1042,1054,5208,0,14,385,2001,71,2096,14
34031223801,0.949119373776908,0.050880626223091974,281,0,911,27,41,"Census Tract 2238.01, Passaic County, New Jersey",0,57,0,0,0,51,173,657,313,970,351,510,1906,22,28,893,1022,52,861,50
34031223802,0.9940119760479041,0.005988023952095809,479,0.004790419161676647,3485,40,333,"Census Tract 2238.02, Passaic County, New Jersey",12,63,0,0,97,0,319,2220,270,2490,1681,1694,7015,110,0,621,2505,15,3375,110
34031223900,NaN,NaN,0,NaN,0,0,4,"Census Tract 2239, Passaic County, New Jersey",0,0,0,0,0,0,0,0,0,0,0,0,0,0,0,0,0,0,0,0
34031236601,0.915863840719332,0.08413615928066795,229,0,1065,73,83,"Census Tract 2366.01, Passaic County, New Jersey",0,9,6,0,13,56,145,1222,204,1426,581,484,3761,0,0,520,1557,131,1065,0
34031236602,0.9339655778011943,0.06603442219880576,976,0,1750,81,121,"Census Tract 2366.02, Passaic County, New Jersey",0,14,146,527,0,10,279,2264,395,2659,755,935,6364,43,17,561,2847,188,1690,60
34031246001,0.9682539682539683,0.031746031746031744,608,0,1312,115,171,"Census Tract 2460.01, Passaic County, New Jersey",0,89,252,183,38,8,38,1251,457,1708,759,457,3404,71,25,914,1764,56,1216,96
34031246002,0.985280588776449,0.014719411223551058,85,0,1411,0,94,"Census Tract 2460.02, Passaic County, New Jersey",0,0,16,0,0,35,34,1027,44,1071,850,552,2897,9,0,44,1087,16,1402,9
34031246003,0.964769647696477,0.03523035230352303,73,0,1809,9,187,"Census Tract 2460.03, Passaic County, New Jersey",0,0,10,30,12,9,12,1706,74,1780,938,871,5197,0,0,201,1845,65,1809,0
34031246101,1,0,600,0,2347,118,161,"Census Tract 2461.01, Passaic County, New Jersey",0,368,55,28,113,36,0,1955,363,2318,1339,975,5610,0,33,1032,2318,0,2314,33
34031246102,0.978882833787466,0.02111716621253406,1376,0,422,89,155,"Census Tract 2461.02, Passaic County, New Jersey",0,317,122,271,288,254,124,385,1052,1437,147,40,751,122,113,2248,1468,31,187,235
34031246103,0.938927738927739,0.061072261072261075,210,0,2847,55,173,"Census Tract 2461.03, Passaic County, New Jersey",0,141,34,0,19,16,0,1656,358,2014,1300,1498,5033,0,49,1015,2145,131,2798,49
34031246104,0.9952941176470588,0.004705882352941176,440,0,1204,190,36,"Census Tract 2461.04, Passaic County, New Jersey",0,0,38,349,0,12,41,841,428,1269,586,534,2639,56,28,453,1275,6,1120,84
34031246201,0.9842931937172775,0.015706806282722512,28,0,2252,0,289,"Census Tract 2462.01, Passaic County, New Jersey",0,0,0,0,0,0,28,1844,36,1880,1140,1112,5858,0,0,149,1910,30,2252,0
34031246202,0.9521337946943483,0.04786620530565167,0,0.004036908881199538,2189,27,144,"Census Tract 2462.02, Passaic County, New Jersey",7,0,0,0,0,0,0,1591,60,1651,988,1145,4841,24,32,220,1734,83,2133,56
34031246203,0.9759939984996249,0.024006001500375095,13,0,1393,28,133,"Census Tract 2462.03, Passaic County, New Jersey",0,0,0,13,0,0,0,1233,68,1301,771,611,3743,0,11,201,1333,32,1382,11
34031246300,0.9249183895538629,0.0750816104461371,538,0.10718171926006528,1477,53,151,"Census Tract 2463, Passaic County, New Jersey",197,6,0,451,0,42,39,902,798,1700,1029,353,2809,0,95,2125,1838,138,1382,95
34031256801,0.8442586889573251,0.15574131104267488,55,0,2502,38,198,"Census Tract 2568.01, Passaic County, New Jersey",0,0,0,14,0,0,41,1644,275,1919,1367,912,4758,177,46,865,2273,354,2279,223
34031256802,0.8310344827586207,0.16896551724137931,39,0,1829,60,69,"Census Tract 2568.02, Passaic County, New Jersey",0,0,0,0,0,0,39,1371,75,1446,1107,702,3392,20,0,165,1740,294,1809,20
34031256803,0.8937365010799136,0.1062634989200864,888,0,1802,135,65,"Census Tract 2568.03, Passaic County, New Jersey",0,16,149,474,182,12,55,1694,375,2069,1180,484,4116,122,16,891,2315,246,1664,138
34031256804,0.8950039032006245,0.1049960967993755,22,0,3844,17,99,"Census Tract 2568.04, Passaic County, New Jersey",0,22,0,0,0,0,0,2107,186,2293,2235,1443,6023,166,0,601,2562,269,3678,166
34031256805,0.9378980891719745,0.06210191082802548,93,0,2162,65,54,"Census Tract 2568.05, Passaic County, New Jersey",0,0,0,0,51,8,34,1606,161,1767,987,1046,4845,129,0,404,1884,117,2033,129
34031264101,0.9811104751001717,0.018889524899828276,1071,0,1273,68,153,"Census Tract 2641.01, Passaic County, New Jersey",0,92,0,0,53,45,881,874,840,1714,356,800,2987,39,78,2977,1747,33,1156,117
34031264102,0.9265734265734266,0.07342657342657342,1069,0,1519,79,112,"Census Tract 2641.02, Passaic County, New Jersey",0,263,71,62,364,93,216,1979,671,2650,634,802,4944,32,51,1560,2860,210,1436,83
34031264200,0.8737745098039216,0.12622549019607843,1465,0,248,604,117,"Census Tract 2642, Passaic County, New Jersey",0,93,28,678,131,167,368,141,1285,1426,44,0,504,43,161,3851,1632,206,44,204
34033020100,0.877914951989026,0.12208504801097393,40,0.015089163237311385,736,41,0,"Census Tract 201, Salem County, New Jersey",11,0,0,0,0,15,25,566,74,640,275,405,1489,47,9,199,729,89,680,56
34033020200,0.7986577181208053,0.20134228187919462,187,0,319,46,38,"Census Tract 202, Salem County, New Jersey",0,0,0,10,5,75,97,283,431,714,38,148,741,33,100,1306,894,180,186,133
34033020300,0.8688138256087982,0.1311861743912019,623,0.007069913589945012,445,286,0,"Census Tract 203, Salem County, New Jersey",9,44,0,273,96,135,75,237,869,1106,38,140,605,31,236,2185,1273,167,178,267
34033020400,0.8928255093002657,0.10717449069973428,432,0.042515500442869794,637,103,12,"Census Tract 204, Salem County, New Jersey",48,217,7,0,146,6,56,494,514,1008,295,327,1316,6,9,1305,1129,121,622,15
34033020500,0.8948233360723089,0.10517666392769104,249,0,951,115,44,"Census Tract 205, Salem County, New Jersey",0,43,10,168,20,8,0,786,303,1089,456,434,1923,61,0,532,1217,128,890,61
34033020600,0.848780487804878,0.15121951219512195,90,0.09658536585365854,971,41,43,"Census Tract 206, Salem County, New Jersey",99,31,18,0,35,0,6,670,200,870,306,659,1831,6,0,489,1025,155,965,6
34033020700,0.9372822299651568,0.0627177700348432,190,0,1648,146,21,"Census Tract 207, Salem County, New Jersey",0,8,41,75,39,8,19,1288,326,1614,634,1014,3070,0,0,857,1722,108,1648,0
34033020800,0.8435504469987228,0.15644955300127714,574,0.017879948914431672,722,74,4,"Census Tract 208, Salem County, New Jersey",28,66,34,52,114,121,187,787,534,1321,259,454,2223,9,0,1228,1566,245,713,9
34033020900,0.9428571428571428,0.05714285714285714,10,0.09061224489795919,1580,15,0,"Census Tract 209, Salem County, New Jersey",111,0,0,0,0,10,0,965,190,1155,800,710,2605,16,54,608,1225,70,1510,70
34033021000,0.9257142857142857,0.07428571428571429,117,0.005714285714285714,481,2,0,"Census Tract 210, Salem County, New Jersey",3,0,0,0,11,53,53,320,166,486,198,267,986,13,3,454,525,39,465,16
34033021101,0.9323748668796592,0.06762513312034078,0,0.21458998935037274,2149,48,0,"Census Tract 211.01, Salem County, New Jersey",403,0,0,0,0,0,0,1682,69,1751,1076,1063,4617,10,0,113,1878,127,2139,10
34033021102,0.887291546866015,0.11270845313398505,35,0.07015526164462335,1818,40,0,"Census Tract 211.02, Salem County, New Jersey",122,0,0,0,0,0,35,1367,176,1543,835,953,3493,30,0,543,1739,196,1788,30
34033021201,0.8784773060029283,0.12152269399707175,76,0.019765739385065886,1095,0,7,"Census Tract 212.01, Salem County, New Jersey",27,0,0,0,0,33,43,1069,131,1200,476,604,2710,15,0,437,1366,166,1080,15
34033021202,0.8763183125599233,0.1236816874400767,45,0.09108341323106424,931,30,0,"Census Tract 212.02, Salem County, New Jersey",95,0,0,0,0,0,45,799,115,914,359,568,2115,4,0,246,1043,129,927,4
34033021300,0.8152753108348135,0.1847246891651865,7,0,711,26,5,"Census Tract 213, Salem County, New Jersey",0,0,0,7,0,0,0,416,43,459,310,388,1215,10,3,177,563,104,698,13
34033021400,0.8651898734177215,0.13481012658227848,316,0.14240506329113925,1127,117,0,"Census Tract 214, Salem County, New Jersey",225,0,0,121,24,79,92,1024,343,1367,372,697,2590,58,0,703,1580,213,1069,58
34033021500,0.8968446601941747,0.10315533980582524,149,0,686,65,0,"Census Tract 215, Salem County, New Jersey",0,52,0,7,8,30,52,490,249,739,392,277,1281,17,0,665,824,85,669,17
34033021600,0.811623246492986,0.18837675350701402,341,0.0156312625250501,2163,144,18,"Census Tract 216, Salem County, New Jersey",39,68,0,112,15,117,29,1620,405,2025,683,1284,4484,179,17,983,2495,470,1967,196
34033021700,0.9339430894308943,0.06605691056910569,401,0,759,52,0,"Census Tract 217, Salem County, New Jersey",0,92,70,67,116,39,17,503,416,919,366,299,1219,94,0,718,984,65,665,94
34033021900,0.6835164835164835,0.31648351648351647,276,0,587,70,0,"Census Tract 219, Salem County, New Jersey",0,0,34,0,64,71,107,280,342,622,237,189,698,86,75,864,910,288,426,161
34033022000,0.7284836065573771,0.27151639344262296,402,0.0235655737704918,361,243,61,"Census Tract 220, Salem County, New Jersey",23,125,0,27,83,78,89,132,579,711,15,189,359,125,32,1563,976,265,204,157
34033022100,0.7606516290726817,0.23934837092731828,185,0,203,122,4,"Census Tract 221, Salem County, New Jersey",0,15,53,8,41,12,56,209,398,607,15,157,432,18,13,867,798,191,172,31
34033022201,0.9169139465875371,0.0830860534124629,8,0.010385756676557863,771,0,0,"Census Tract 222.01, Salem County, New Jersey",7,0,0,0,0,0,8,509,109,618,335,399,1439,24,13,271,674,56,734,37
34033022202,0.8447937131630648,0.15520628683693516,19,0,317,23,5,"Census Tract 222.02, Salem County, New Jersey",0,11,0,0,1,2,5,357,73,430,95,219,876,3,0,176,509,79,314,3
34033990000,NaN,NaN,0,NaN,0,0,0,"Census Tract 9900, Salem County, New Jersey",0,0,0,0,0,0,0,0,0,0,0,0,0,0,0,0,0,0,0,0
34035050100,0.8236151603498543,0.17638483965014579,879,0.007288629737609329,606,211,21,"Census Tract 501, Somerset County, New Jersey",10,0,128,252,48,140,311,459,671,1130,153,340,1467,103,10,1301,1372,242,493,113
34035050200,0.7473997028231798,0.2526002971768202,1044,0,409,93,57,"Census Tract 502, Somerset County, New Jersey",0,285,87,46,199,237,190,268,738,1006,157,210,837,12,30,2014,1346,340,367,42
34035050300,0.9210711768851304,0.07892882311486962,228,0,1462,42,42,"Census Tract 503, Somerset County, New Jersey",0,0,66,69,0,27,66,1118,189,1307,731,724,3128,7,0,406,1419,112,1455,7
34035050400,0.7504078303425775,0.2495921696574225,646,0,470,113,15,"Census Tract 504, Somerset County, New Jersey",0,32,71,94,95,116,238,294,626,920,48,248,774,142,32,1779,1226,306,296,174
34035050500,0.8495481127060075,0.15045188729399256,1226,0,992,142,15,"Census Tract 505, Somerset County, New Jersey",0,72,99,333,9,201,512,598,1000,1598,499,476,1561,0,17,2329,1881,283,975,17
34035050600,0.9351011863224006,0.06489881367759945,274,0,1821,42,75,"Census Tract 506, Somerset County, New Jersey",0,0,0,0,0,37,237,1078,262,1340,1093,728,3315,0,0,581,1433,93,1821,0
34035050701,0.9451851851851852,0.054814814814814816,86,0,1905,36,129,"Census Tract 507.01, Somerset County, New Jersey",0,9,0,11,8,9,49,1088,188,1276,940,875,3622,0,90,608,1350,74,1815,90
34035050703,1,0,552,0,1376,260,88,"Census Tract 507.03, Somerset County, New Jersey",0,25,41,309,113,55,9,1226,533,1759,1239,73,4027,64,0,837,1759,0,1312,64
34035050704,0.9874312647289867,0.012568735271013355,565,0,1652,56,124,"Census Tract 507.04, Somerset County, New Jersey",0,209,57,11,188,100,0,2257,257,2514,1405,218,5928,29,0,721,2546,32,1623,29
34035050801,0.9629629629629629,0.037037037037037035,11,0,1571,12,36,"Census Tract 508.01, Somerset County, New Jersey",0,0,0,0,0,0,11,1146,24,1170,793,726,3719,52,0,104,1215,45,1519,52
34035050802,0.9911838790931989,0.008816120906801008,210,0,1309,81,56,"Census Tract 508.02, Somerset County, New Jersey",0,85,0,73,39,13,0,1319,255,1574,787,504,3652,18,0,649,1588,14,1291,18
34035050901,0.9782608695652174,0.021739130434782608,165,0,2125,19,71,"Census Tract 509.01, Somerset County, New Jersey",0,20,136,0,0,9,0,1630,35,1665,1181,944,4501,0,0,90,1702,37,2125,0
34035050902,0.9698890649762282,0.030110935023771792,32,0,1636,17,64,"Census Tract 509.02, Somerset County, New Jersey",0,0,0,22,0,0,10,1131,93,1224,822,792,3413,22,0,244,1262,38,1614,22
34035050903,0.9664053751399776,0.0335946248600224,47,0,1859,38,209,"Census Tract 509.03, Somerset County, New Jersey",0,0,0,0,10,37,0,1633,93,1726,1268,580,4948,11,0,245,1786,60,1848,11
34035051000,0.9335863377609108,0.06641366223908918,1244,0,1804,78,81,"Census Tract 510, Somerset County, New Jersey",0,195,70,189,425,289,76,1482,978,2460,740,860,4010,204,0,2686,2635,175,1600,204
34035051100,0.7780026990553306,0.22199730094466938,993,0,311,100,143,"Census Tract 511, Somerset County, New Jersey",0,27,149,173,71,212,361,326,827,1153,30,261,1101,20,0,1965,1482,329,291,20
34035051200,0.8285426122037317,0.1714573877962683,1006,0,602,159,157,"Census Tract 512, Somerset County, New Jersey",0,43,50,78,11,520,304,850,793,1643,176,363,2707,63,0,2555,1983,340,539,63
34035051300,0.8871359223300971,0.11286407766990292,92,0.007281553398058253,660,16,64,"Census Tract 513, Somerset County, New Jersey",6,10,12,5,25,0,40,589,142,731,332,313,1541,0,15,416,824,93,645,15
34035051400,0.8538597525044196,0.14614024749558044,362,0,1305,101,43,"Census Tract 514, Somerset County, New Jersey",0,33,0,0,79,76,174,1175,274,1449,538,747,3087,11,9,769,1697,248,1285,20
34035051500,0.8892238131122834,0.11077618688771665,617,0,614,101,60,"Census Tract 515, Somerset County, New Jersey",0,68,0,0,137,71,341,513,667,1180,232,281,1618,53,48,1681,1327,147,513,101
34035051600,0.9024199843871975,0.0975800156128025,343,0,906,124,0,"Census Tract 516, Somerset County, New Jersey",0,59,0,0,0,11,273,817,339,1156,371,524,2064,11,0,1059,1281,125,895,11
34035051700,0.9326984126984127,0.0673015873015873,959,0,1599,232,297,"Census Tract 517, Somerset County, New Jersey",0,12,0,0,51,144,752,775,694,1469,1264,230,2991,23,82,1997,1575,106,1494,105
34035051800,0.9643366619115549,0.03566333808844508,758,0,829,261,59,"Census Tract 518, Somerset County, New Jersey",0,13,117,61,0,298,269,592,760,1352,402,305,1977,87,35,2060,1402,50,707,122
34035051900,0.9602026049204052,0.03979739507959479,155,0,1118,28,94,"Census Tract 519, Somerset County, New Jersey",0,130,0,0,17,0,8,1141,186,1327,646,449,3203,0,23,284,1382,55,1095,23
34035052001,0.941501976284585,0.05849802371541502,60,0,1782,77,137,"Census Tract 520.01, Somerset County, New Jersey",0,0,0,0,0,0,60,1024,167,1191,1182,600,3770,0,0,771,1265,74,1782,0
34035052002,0.9455782312925171,0.05442176870748299,1848,0,665,132,87,"Census Tract 520.02, Somerset County, New Jersey",0,433,155,152,526,231,351,420,1665,2085,451,80,1211,121,13,3335,2205,120,531,134
34035052100,0.9709507042253521,0.029049295774647887,192,0,2341,22,226,"Census Tract 521, Somerset County, New Jersey",0,60,31,0,46,55,0,2083,123,2206,1419,922,6523,0,0,353,2272,66,2341,0
34035052201,0.9115504682622269,0.08844953173777315,196,0,2334,97,64,"Census Tract 522.01, Somerset County, New Jersey",0,47,13,78,49,9,0,1536,216,1752,1336,990,4804,8,0,457,1922,170,2326,8
34035052203,0.9912376779846659,0.008762322015334063,82,0,2008,78,121,"Census Tract 522.03, Somerset County, New Jersey",0,0,0,0,58,24,0,1746,64,1810,1392,605,5315,0,11,104,1826,16,1997,11
34035052204,0.9857496902106567,0.014250309789343246,41,0,1679,0,93,"Census Tract 522.04, Somerset County, New Jersey",0,18,11,0,12,0,0,1476,115,1591,749,918,4588,12,0,393,1614,23,1667,12
34035052300,0.8581111613194758,0.14188883868052418,577,0,2051,70,223,"Census Tract 523, Somerset County, New Jersey",0,67,120,129,82,21,158,1471,428,1899,1098,924,4804,29,0,1050,2213,314,2022,29
34035052400,0.9766169154228855,0.023383084577114428,365,0,1803,153,200,"Census Tract 524, Somerset County, New Jersey",0,42,55,52,157,40,19,1574,389,1963,1185,609,5000,9,0,569,2010,47,1794,9
34035052601,0.9536381197681906,0.0463618802318094,264,0.00643915003219575,1902,53,415,"Census Tract 526.01, Somerset County, New Jersey",20,74,59,131,0,0,0,2594,368,2962,1249,633,8344,20,0,816,3106,144,1882,20
34035052603,0.9479850046860356,0.052014995313964384,1131,0,1268,121,93,"Census Tract 526.03, Somerset County, New Jersey",0,339,0,34,365,381,12,1583,440,2023,1058,174,3484,36,0,717,2134,111,1232,36
34035052700,0.9649566473988439,0.03504335260115607,323,0,1800,112,336,"Census Tract 527, Somerset County, New Jersey",0,0,55,0,28,17,223,2292,379,2671,1008,764,6635,28,0,1054,2768,97,1772,28
34035052800,0.9374301675977653,0.06256983240223464,114,0,846,17,62,"Census Tract 528, Somerset County, New Jersey",0,7,0,0,25,77,5,670,169,839,411,435,1890,0,0,388,895,56,846,0
34035052901,0.8814016172506739,0.11859838274932614,48,0.008086253369272238,225,2,26,"Census Tract 529.01, Somerset County, New Jersey",3,15,17,3,0,6,7,253,74,327,126,76,634,21,2,226,371,44,202,23
34035052903,0.9529161603888214,0.04708383961117862,1382,0,1037,66,51,"Census Tract 529.03, Somerset County, New Jersey",0,360,218,42,463,271,28,2379,758,3137,726,253,4532,13,45,1521,3292,155,979,58
34035052904,0.8510416666666667,0.14895833333333333,22,0.00625,866,19,29,"Census Tract 529.04, Somerset County, New Jersey",6,0,0,0,0,0,22,646,171,817,346,497,1633,0,23,305,960,143,843,23
34035053000,0.8407032498668088,0.15929675013319125,768,0,1509,152,60,"Census Tract 530, Somerset County, New Jersey",0,61,100,26,102,153,326,908,670,1578,830,568,2682,102,9,1835,1877,299,1398,111
34035053102,0.9353374929098128,0.06466250709018719,952,0,904,99,278,"Census Tract 531.02, Somerset County, New Jersey",0,454,58,302,93,8,37,792,857,1649,439,347,2304,94,24,1828,1763,114,786,118
34035053103,0.9271070615034168,0.07289293849658314,22,0.006264236902050114,1992,0,227,"Census Tract 531.03, Somerset County, New Jersey",11,0,0,0,0,0,22,1525,103,1628,628,1168,5129,101,95,584,1756,128,1796,196
34035053105,0.9481815255873833,0.05181847441261667,444,0,1872,40,493,"Census Tract 531.05, Somerset County, New Jersey",0,161,14,0,90,132,47,2238,708,2946,1038,695,5195,139,0,1699,3107,161,1733,139
34035053200,0.8715824357912179,0.12841756420878211,664,0,1751,40,110,"Census Tract 532, Somerset County, New Jersey",0,0,0,0,133,275,256,1501,603,2104,821,661,4423,0,269,1919,2414,310,1482,269
34035053300,0.8313373253493014,0.1686626746506986,795,0,829,187,76,"Census Tract 533, Somerset County, New Jersey",0,46,114,373,0,91,171,733,933,1666,174,640,2646,0,15,2570,2004,338,814,15
34035053402,0.9453183520599251,0.05468164794007491,457,0,2268,60,312,"Census Tract 534.02, Somerset County, New Jersey",0,128,21,18,163,116,11,1987,537,2524,1841,395,5434,32,0,1364,2670,146,2236,32
34035053403,0.8848028356225077,0.11519716437749225,1090,0,1089,70,119,"Census Tract 534.03, Somerset County, New Jersey",0,268,34,21,534,192,41,1459,538,1997,953,119,3393,17,0,1179,2257,260,1072,17
34035053404,0.9263207770670457,0.07367922293295427,1899,0,2369,240,682,"Census Tract 534.04, Somerset County, New Jersey",0,1079,224,107,85,355,49,1979,1931,3910,1455,319,5864,234,361,5003,4221,311,1774,595
34035053501,0.8456046407853637,0.15439535921463632,499,0,734,94,62,"Census Tract 535.01, Somerset County, New Jersey",0,35,282,131,34,17,0,1639,256,1895,347,387,3993,0,0,633,2241,346,734,0
34035053602,0.9833107803337844,0.016689219666215605,273,0,2456,36,82,"Census Tract 536.02, Somerset County, New Jersey",0,70,87,19,25,36,36,1832,348,2180,1589,828,5348,39,0,884,2217,37,2417,39
34035053603,0.9767836919592299,0.0232163080407701,125,0.04360135900339751,1742,44,77,"Census Tract 536.03, Somerset County, New Jersey",77,67,38,0,0,11,9,1655,70,1725,1081,661,4591,0,0,218,1766,41,1742,0
34035053604,0.9457044673539519,0.05429553264604811,207,0.04742268041237113,979,18,70,"Census Tract 536.04, Somerset County, New Jersey",69,89,7,0,98,13,0,1166,210,1376,617,362,3026,0,0,412,1455,79,979,0
34035053703,0.921875,0.078125,33,0,1340,41,33,"Census Tract 537.03, Somerset County, New Jersey",0,0,0,0,0,0,33,1210,29,1239,707,614,3849,0,19,62,1344,105,1321,19
34035053704,0.9849094567404426,0.015090543259557344,16,0,1345,5,32,"Census Tract 537.04, Somerset County, New Jersey",0,0,0,7,0,0,9,944,35,979,954,380,2812,0,11,110,994,15,1334,11
34035053705,0.9075829383886256,0.0924170616113744,883,0,1148,83,137,"Census Tract 537.05, Somerset County, New Jersey",0,336,123,121,135,123,45,1788,893,2681,918,217,3958,13,0,2163,2954,273,1135,13
34035053706,0.9206440483036228,0.07935595169637723,103,0,1787,27,104,"Census Tract 537.06, Somerset County, New Jersey",0,44,18,9,17,10,5,1352,249,1601,1437,272,4210,78,0,889,1739,138,1709,78
34035053707,0.975752508361204,0.024247491638795988,0,0.005852842809364548,1408,24,52,"Census Tract 537.07, Somerset County, New Jersey",7,0,0,0,0,0,0,1126,41,1167,865,528,3525,15,0,72,1196,29,1393,15
34035053801,0.9221556886227545,0.07784431137724551,13,0,198,2,3,"Census Tract 538.01, Somerset County, New Jersey",0,0,0,0,0,3,10,138,16,154,101,97,452,0,0,31,167,13,198,0
34035053803,0.9562098905247263,0.04379010947527369,91,0,2561,34,250,"Census Tract 538.03, Somerset County, New Jersey",0,22,0,0,0,24,45,2441,92,2533,1570,991,8170,0,0,198,2649,116,2561,0
34035053804,0.9024495058014611,0.0975504941985389,944,0,1437,38,94,"Census Tract 538.04, Somerset County, New Jersey",0,452,141,15,120,124,92,1462,638,2100,842,513,4080,66,16,1539,2327,227,1355,82
34035053805,0.9253945480631277,0.0746054519368723,137,0,1574,111,72,"Census Tract 538.05, Somerset County, New Jersey",0,23,0,100,0,14,0,1154,136,1290,867,682,3312,0,25,227,1394,104,1549,25
34035053901,0.8149466192170819,0.18505338078291814,29,0,233,3,4,"Census Tract 539.01, Somerset County, New Jersey",0,0,0,0,9,18,2,184,45,229,154,79,491,0,0,92,281,52,233,0
34035053904,1,0,6,0,889,21,76,"Census Tract 539.04, Somerset County, New Jersey",0,0,0,6,0,0,0,1016,15,1031,514,340,3519,29,6,35,1031,0,854,35
34035053905,0.9800708591674048,0.019929140832595216,726,0.0048715677590788304,1647,55,214,"Census Tract 539.05, Somerset County, New Jersey",11,365,59,22,168,102,10,1481,732,2213,1397,240,4804,10,0,1792,2258,45,1637,10
34035054100,0.9670722977809592,0.0329277022190408,614,0,2152,46,234,"Census Tract 541, Somerset County, New Jersey",0,195,21,18,173,169,38,2216,486,2702,1630,522,5977,0,0,1302,2794,92,2152,0
34035054201,0.9828279137742053,0.017172086225794667,495,0,1660,255,471,"Census Tract 542.01, Somerset County, New Jersey",0,130,28,262,61,14,0,2204,486,2690,1093,536,6237,15,16,936,2737,47,1629,31
34035054202,0.9106753812636166,0.08932461873638345,40,0,1423,10,162,"Census Tract 542.02, Somerset County, New Jersey",0,0,16,6,9,9,0,1552,120,1672,902,498,4954,0,23,513,1836,164,1400,23
34035054300,0.9361750112764998,0.06382498872350023,1144,0,1990,358,195,"Census Tract 543, Somerset County, New Jersey",0,306,142,376,262,31,27,3566,585,4151,1355,545,8359,90,0,1111,4434,283,1900,90
34037371000,0.797180043383948,0.20281995661605207,441,0,1326,86,31,"Census Tract 3710, Sussex County, New Jersey",0,48,0,25,131,101,136,1121,349,1470,544,668,2776,114,0,907,1844,374,1212,114
34037371100,0.9486139283299526,0.05138607167004733,231,0,1410,52,9,"Census Tract 3711, Sussex County, New Jersey",0,21,52,76,0,12,70,1159,244,1403,637,761,3496,12,0,448,1479,76,1398,12
34037371200,0.7985685071574642,0.20143149284253578,622,0,536,71,8,"Census Tract 3712, Sussex County, New Jersey",0,186,16,37,110,106,167,291,490,781,172,267,770,57,40,1061,978,197,439,97
34037371300,0.5688423058599333,0.4311576941400667,55,0.19342544068604098,1861,23,65,"Census Tract 3713, Sussex County, New Jersey",406,0,0,0,14,18,23,1088,106,1194,964,721,3127,68,108,299,2099,905,1685,176
34037371400,0.8928870292887029,0.10711297071129706,33,0,1181,12,11,"Census Tract 3714, Sussex County, New Jersey",0,0,0,0,0,0,33,1025,42,1067,437,744,2749,0,0,120,1195,128,1181,0
34037371502,0.7265469061876247,0.27345309381237526,138,0,2297,17,86,"Census Tract 3715.02, Sussex County, New Jersey",0,0,0,12,14,0,112,1684,136,1820,1222,1075,4495,0,0,400,2505,685,2297,0
34037371503,0.9310344827586207,0.06896551724137931,15,0,1321,10,5,"Census Tract 3715.03, Sussex County, New Jersey",0,8,0,7,0,0,0,964,35,999,631,690,2739,0,0,127,1073,74,1321,0
34037371600,0.7157335907335908,0.2842664092664093,1398,0,568,34,0,"Census Tract 3716, Sussex County, New Jersey",0,430,8,20,790,67,83,805,678,1483,67,478,1613,23,0,1276,2072,589,545,23
34037371700,0.9054600606673407,0.09453993933265925,43,0.015672396359959553,2459,73,79,"Census Tract 3717, Sussex County, New Jersey",31,0,0,0,43,0,0,1634,157,1791,1220,1056,4920,77,106,432,1978,187,2276,183
34037371800,0.9181328545780969,0.08186714542190306,131,0,3578,41,6,"Census Tract 3718, Sussex County, New Jersey",0,19,0,0,25,78,9,2333,224,2557,2127,1236,6403,215,0,619,2785,228,3363,215
34037371900,0.7719298245614035,0.22807017543859648,3,0,752,0,8,"Census Tract 3719, Sussex County, New Jersey",0,0,0,0,0,3,0,665,83,748,374,372,1680,0,6,251,969,221,746,6
34037372000,0.8717948717948718,0.1282051282051282,12,0,1438,40,0,"Census Tract 3720, Sussex County, New Jersey",0,0,0,0,0,0,12,1091,99,1190,654,766,2719,18,0,248,1365,175,1420,18
34037372100,0.9385964912280702,0.06140350877192982,50,0.14473684210526316,711,16,15,"Census Tract 3721, Sussex County, New Jersey",132,0,0,0,16,34,0,741,115,856,290,400,1613,0,21,282,912,56,690,21
34037372200,0.6734362307067425,0.32656376929325753,25,0.011372867587327376,888,16,30,"Census Tract 3722, Sussex County, New Jersey",14,0,0,0,5,5,15,691,138,829,440,416,1902,32,0,255,1231,402,856,32
34037372300,0.9509483322432962,0.04905166775670373,158,0,1705,30,14,"Census Tract 3723, Sussex County, New Jersey",0,6,25,9,6,36,76,1152,302,1454,749,838,3140,55,63,772,1529,75,1587,118
34037372400,0.8911419423692636,0.10885805763073639,44,0.016008537886873,1068,18,7,"Census Tract 3724, Sussex County, New Jersey",15,8,0,0,0,0,36,738,97,835,548,492,2042,11,17,279,937,102,1040,28
34037372500,0.8802308802308803,0.11976911976911978,290,0,467,71,17,"Census Tract 3725, Sussex County, New Jersey",0,134,0,0,92,39,25,789,431,1220,203,254,1949,0,10,1180,1386,166,457,10
34037372600,0.8151898734177215,0.1848101265822785,244,0.0033755274261603376,1553,7,165,"Census Tract 3726, Sussex County, New Jersey",8,25,0,0,114,74,31,1781,151,1932,814,712,4415,27,0,320,2370,438,1526,27
34037372700,0.9108367626886146,0.08916323731138547,504,0,1162,57,20,"Census Tract 3727, Sussex County, New Jersey",0,119,0,0,232,111,42,997,331,1328,532,548,2553,62,20,593,1458,130,1080,82
34037372800,0.9245283018867925,0.07547169811320754,99,0.2628032345013477,585,23,16,"Census Tract 3728, Sussex County, New Jersey",195,16,0,10,43,30,0,583,103,686,273,296,1431,10,6,243,742,56,569,16
34037372900,0.8358310626702997,0.16416893732970028,459,0.006130790190735695,1064,87,54,"Census Tract 3729, Sussex County, New Jersey",9,59,52,56,18,159,115,815,412,1227,317,670,2244,77,0,850,1468,241,987,77
34037373000,0.8812095032397408,0.11879049676025918,139,0.011879049676025918,1019,39,26,"Census Tract 3730, Sussex County, New Jersey",11,2,0,0,22,18,97,684,132,816,359,632,2006,0,28,308,926,110,991,28
34037373100,0.9352306182531894,0.0647693817468106,102,0,1357,36,56,"Census Tract 3731, Sussex County, New Jersey",0,27,39,0,10,0,26,1718,188,1906,813,526,5445,0,18,636,2038,132,1339,18
34037373200,0.8178887993553586,0.18211120064464142,5,0,1067,0,49,"Census Tract 3732, Sussex County, New Jersey",0,5,0,0,0,0,0,996,19,1015,706,331,3268,21,9,35,1241,226,1037,30
34037373300,0.9469767441860465,0.053023255813953486,97,0,1101,47,69,"Census Tract 3733, Sussex County, New Jersey",0,11,0,0,0,41,45,881,137,1018,733,298,2763,70,0,294,1075,57,1031,70
34037373400,0.8862624186365193,0.11373758136348064,208,0,1860,99,117,"Census Tract 3734, Sussex County, New Jersey",0,13,45,0,14,121,15,2188,399,2587,1260,557,5703,43,0,586,2919,332,1817,43
34037373500,0.894283476898982,0.105716523101018,81,0.021143304620203602,1187,26,17,"Census Tract 3735, Sussex County, New Jersey",27,0,0,0,31,20,30,976,166,1142,729,448,2440,10,0,403,1277,135,1177,10
34037373600,0.9595872742906277,0.040412725709372314,338,0,910,57,20,"Census Tract 3736, Sussex County, New Jersey",0,0,0,0,249,81,8,916,200,1116,486,348,2523,26,50,352,1163,47,834,76
34037373700,0.8319159579789895,0.16808404202101052,1144,0,745,318,37,"Census Tract 3737, Sussex County, New Jersey",0,197,53,471,177,90,156,624,1039,1663,262,317,1386,138,28,2186,1999,336,579,166
34037373800,0.8846364133406233,0.11536358665937671,439,0,1385,111,12,"Census Tract 3738, Sussex County, New Jersey",0,0,49,45,101,49,195,934,684,1618,698,620,2269,34,33,1606,1829,211,1318,67
34037373900,0.8257918552036199,0.17420814479638008,87,0.035633484162895926,2318,20,8,"Census Tract 3739, Sussex County, New Jersey",63,0,0,0,38,0,49,1317,143,1460,1265,1025,3619,0,28,317,1768,308,2290,28
34037374000,0.9064869418702611,0.09351305812973884,48,0,1483,11,41,"Census Tract 3740, Sussex County, New Jersey",0,0,0,0,13,15,20,960,116,1076,951,523,2856,0,9,337,1187,111,1474,9
34037374100,0.8983174835405998,0.10168251645940014,24,0,1108,35,31,"Census Tract 3741, Sussex County, New Jersey",0,0,0,0,0,0,24,1162,66,1228,570,530,3289,8,0,191,1367,139,1100,8
34037374200,0.8871745419479267,0.1128254580520733,31,0.019286403085824494,1018,10,11,"Census Tract 3742, Sussex County, New Jersey",20,0,0,0,0,16,15,816,104,920,524,489,2091,0,5,255,1037,117,1013,5
34037374300,0.8928307464892831,0.10716925351071692,10,0,1607,11,20,"Census Tract 3743, Sussex County, New Jersey",0,0,0,0,10,0,0,1161,47,1208,955,579,3170,73,0,134,1353,145,1534,73
34037374400,0.8894907908992417,0.1105092091007584,0,0,964,27,28,"Census Tract 3744, Sussex County, New Jersey",0,0,0,0,0,0,0,791,30,821,670,294,2302,0,0,47,923,102,964,0
34037374500,0.7840327533265097,0.21596724667349027,48,0,861,31,46,"Census Tract 3745, Sussex County, New Jersey",0,0,10,0,0,0,38,608,158,766,373,456,1509,27,5,353,977,211,829,32
34037374600,0.9318820224719101,0.06811797752808989,309,0,1137,28,10,"Census Tract 3746, Sussex County, New Jersey",0,73,54,0,81,71,30,1096,231,1327,671,466,2860,0,0,503,1424,97,1137,0
34037374700,0.8286915396741986,0.17130846032580135,126,0.009458749343142408,1824,61,17,"Census Tract 3747, Sussex County, New Jersey",18,0,0,0,19,93,14,1343,234,1577,975,837,3497,6,6,449,1903,326,1812,12
34037374800,0.8828213879408419,0.11717861205915814,95,0.011376564277588168,1724,47,39,"Census Tract 3748, Sussex County, New Jersey",20,0,12,10,19,0,54,1360,192,1552,721,926,3599,77,0,321,1758,206,1647,77
34037374900,0.9143013100436681,0.08569868995633188,22,0,1727,45,13,"Census Tract 3749, Sussex County, New Jersey",0,0,0,0,14,8,0,1329,346,1675,704,957,3718,66,0,876,1832,157,1661,66
34039030200,0.9116279069767442,0.08837209302325581,978,0,278,364,107,"Census Tract 302, Union County, New Jersey",0,22,10,0,177,172,597,189,791,980,104,88,573,60,26,2757,1075,95,192,86
34039030400,0.904688304997424,0.095311695002576,1411,0,290,722,268,"Census Tract 304, Union County, New Jersey",0,65,53,113,164,200,816,311,1445,1756,76,78,1172,40,96,4402,1941,185,154,136
34039030500,0.8326670474014849,0.16733295259851513,1470,0,452,307,174,"Census Tract 305, Union County, New Jersey",0,54,0,17,116,304,979,429,1029,1458,88,271,1425,93,0,3809,1751,293,359,93
34039030600,0.914074074074074,0.08592592592592592,1132,0,570,363,102,"Census Tract 306, Union County, New Jersey",0,40,0,45,412,239,396,289,945,1234,45,181,775,149,195,2577,1350,116,226,344
34039030701,0.9201954397394136,0.07980456026058631,477,0.016286644951140065,433,50,59,"Census Tract 307.01, Union County, New Jersey",10,9,16,10,17,130,295,201,364,565,150,145,791,118,20,987,614,49,295,138
34039030702,0.926509186351706,0.07349081364829396,2340,0,1198,320,226,"Census Tract 307.02, Union County, New Jersey",0,275,192,214,209,392,1058,598,1873,2471,334,186,1946,520,158,6191,2667,196,520,678
34039030802,0.8432908912830558,0.15670910871694418,852,0,402,120,61,"Census Tract 308.02, Union County, New Jersey",0,85,94,10,78,123,462,247,614,861,154,233,932,4,11,1975,1021,160,387,15
34039030900,0.9393139841688655,0.06068601583113457,1442,0.011609498680738786,1306,362,183,"Census Tract 309, Union County, New Jersey",22,23,0,0,62,317,1040,625,1155,1780,284,638,2208,345,39,4051,1895,115,922,384
34039031000,0.8332063975628332,0.1667936024371668,1176,0,319,411,236,"Census Tract 310, Union County, New Jersey",0,10,30,0,41,320,775,183,911,1094,43,95,783,124,57,3337,1313,219,138,181
34039031100,0.9252669039145908,0.07473309608540925,1610,0,749,740,261,"Census Tract 311, Union County, New Jersey",0,88,30,106,212,422,752,304,1516,1820,226,336,988,131,56,4839,1967,147,562,187
34039031200,0.8622448979591837,0.1377551020408163,1677,0,631,504,302,"Census Tract 312, Union County, New Jersey",0,89,136,80,262,294,816,340,1350,1690,109,228,1135,162,132,4471,1960,270,337,294
34039031300,0.8733914487339145,0.1266085512660855,1814,0,1542,395,399,"Census Tract 313, Union County, New Jersey",0,54,0,0,70,437,1253,765,1339,2104,443,923,2789,43,133,4323,2409,305,1366,176
34039031400,0.8972943125345113,0.10270568746548868,1595,0.004417448923246825,650,446,451,"Census Tract 314, Union County, New Jersey",8,149,220,66,174,365,621,405,1220,1625,102,307,1475,43,198,4011,1811,186,409,241
34039031500,0.9095427435387674,0.09045725646123261,1687,0,1017,145,243,"Census Tract 315, Union County, New Jersey",0,51,92,117,120,518,789,435,1395,1830,101,657,1443,150,109,4298,2012,182,758,259
34039031601,0.9650602409638555,0.03493975903614458,1574,0.007228915662650603,278,380,445,"Census Tract 316.01, Union County, New Jersey",12,125,606,536,170,61,76,78,1524,1602,12,59,166,128,79,3452,1660,58,71,207
34039031602,0.9540449976065103,0.04595500239348971,1795,0.003350885591191958,839,391,404,"Census Tract 316.02, Union County, New Jersey",7,62,204,317,167,554,491,285,1708,1993,112,372,989,187,168,4089,2089,96,484,355
34039031700,0.8802264808362369,0.11977351916376307,1951,0,707,755,465,"Census Tract 317, Union County, New Jersey",0,325,538,553,253,263,19,294,1727,2021,295,182,1074,162,68,4428,2296,275,477,230
34039031801,0.9419496166484118,0.05805038335158817,1421,0,621,383,273,"Census Tract 318.01, Union County, New Jersey",0,83,413,77,274,104,470,450,1270,1720,346,119,1681,87,69,3587,1826,106,465,156
34039031802,0.9117896522476675,0.08821034775233248,956,0,555,240,282,"Census Tract 318.02, Union County, New Jersey",0,179,411,94,114,32,126,182,893,1075,139,33,469,278,105,2467,1179,104,172,383
34039031903,0.9826711749788672,0.017328825021132713,2133,0,828,476,226,"Census Tract 319.03, Union County, New Jersey",0,501,566,444,163,23,436,180,2145,2325,127,113,567,431,157,5685,2366,41,240,588
34039031904,0.8876636802205375,0.11233631977946244,1366,0,292,477,314,"Census Tract 319.04, Union County, New Jersey",0,212,330,353,266,60,145,175,1113,1288,151,35,518,99,7,2530,1451,163,186,106
34039032001,0.9036144578313253,0.0963855421686747,1888,0,774,240,433,"Census Tract 320.01, Union County, New Jersey",0,177,484,93,31,375,728,600,1500,2100,101,454,2358,160,59,5222,2324,224,555,219
34039032002,0.9348350764279968,0.06516492357200322,838,0,763,114,47,"Census Tract 320.02, Union County, New Jersey",0,137,81,29,108,76,407,416,746,1162,321,268,1546,43,131,2247,1243,81,589,174
34039032100,0.9379990605918271,0.06200093940817285,354,0,3081,64,441,"Census Tract 321, Union County, New Jersey",0,141,97,0,66,0,50,1563,434,1997,1605,1461,5640,0,15,1284,2129,132,3066,15
34039032200,0.9482837528604119,0.0517162471395881,642,0,1812,174,408,"Census Tract 322, Union County, New Jersey",0,8,39,10,60,185,340,1400,672,2072,254,1295,3671,33,230,2104,2185,113,1549,263
34039032300,0.9059734513274337,0.09402654867256637,627,0,750,62,103,"Census Tract 323, Union County, New Jersey",0,0,6,34,0,246,341,325,494,819,403,194,1179,148,5,1397,904,85,597,153
34039032400,0.9438492796453639,0.05615072035463613,1164,0.014776505356483192,1967,133,464,"Census Tract 324, Union County, New Jersey",40,48,0,40,31,330,715,1645,910,2555,833,842,5060,213,79,2401,2707,152,1675,292
34039032500,0.9515119916579771,0.048488008342022944,248,0,1888,116,474,"Census Tract 325, Union County, New Jersey",0,0,35,0,55,61,97,1340,485,1825,1201,613,4401,35,39,1661,1918,93,1814,74
34039032600,0.9631931166347992,0.036806883365200764,1151,0,994,135,325,"Census Tract 326, Union County, New Jersey",0,23,46,188,21,595,278,911,1104,2015,584,314,2748,88,8,2488,2092,77,898,96
34039032700,0.9721634954193094,0.027836504580690626,673,0,2700,112,418,"Census Tract 327, Union County, New Jersey",0,14,50,85,86,79,359,2179,580,2759,1429,1049,6386,55,167,1345,2838,79,2478,222
34039032800,0.8805748265609514,0.11942517343904856,821,0.027254707631318136,1845,235,203,"Census Tract 328, Union County, New Jersey",55,0,0,11,0,172,638,1079,698,1777,817,849,2835,73,106,1724,2018,241,1666,179
34039032901,0.965948575399583,0.034051424600416956,254,0,1444,102,82,"Census Tract 329.01, Union County, New Jersey",0,8,0,44,0,52,150,1110,280,1390,817,474,3282,153,0,636,1439,49,1291,153
34039032902,0.9650313152400835,0.03496868475991649,351,0,1711,132,168,"Census Tract 329.02, Union County, New Jersey",0,19,10,10,91,12,209,1471,378,1849,629,975,4533,58,49,762,1916,67,1604,107
34039033000,0.9561354802887285,0.04386451971127152,874,0,1260,55,171,"Census Tract 330, Union County, New Jersey",0,228,0,135,143,32,336,1223,499,1722,519,613,3314,0,128,1225,1801,79,1132,128
34039033100,0.959203036053131,0.04079696394686907,418,0,2255,119,258,"Census Tract 331, Union County, New Jersey",0,0,26,56,10,96,230,1532,490,2022,1201,833,4597,167,54,1335,2108,86,2034,221
34039033200,0.9157413455258001,0.08425865447419988,272,0,1156,73,165,"Census Tract 332, Union County, New Jersey",0,0,21,17,0,12,222,1115,287,1402,484,539,3403,111,22,932,1531,129,1023,133
34039033300,1,0,93,0,1499,25,221,"Census Tract 333, Union County, New Jersey",0,14,0,0,22,10,47,1317,135,1452,668,798,3864,33,0,405,1452,0,1466,33
34039033400,0.9391691394658753,0.06083086053412463,62,0,1571,18,274,"Census Tract 334, Union County, New Jersey",0,0,0,0,0,8,54,1179,87,1266,835,736,3608,0,0,155,1348,82,1571,0
34039033500,0.9247994652406417,0.07520053475935828,1245,0,2042,307,404,"Census Tract 335, Union County, New Jersey",0,0,129,762,73,62,219,1913,854,2767,1206,746,5617,90,0,1424,2992,225,1952,90
34039033600,0.9461358313817331,0.053864168618266976,698,0,3200,70,165,"Census Tract 336, Union County, New Jersey",0,0,0,101,17,37,543,2255,573,2828,1727,1394,6133,79,0,2020,2989,161,3121,79
34039033700,0.982078853046595,0.017921146953405017,314,0,1401,58,341,"Census Tract 337, Union County, New Jersey",0,0,134,27,0,21,132,1268,376,1644,300,917,3888,105,79,843,1674,30,1217,184
34039033800,0.9554794520547946,0.04452054794520548,916,0,1619,84,266,"Census Tract 338, Union County, New Jersey",0,109,174,134,94,228,177,1239,993,2232,669,786,3705,57,107,1889,2336,104,1455,164
34039033900,0.9498039215686275,0.05019607843137255,766,0,603,78,286,"Census Tract 339, Union County, New Jersey",0,136,187,10,70,127,236,465,746,1211,184,273,1266,112,34,1972,1275,64,457,146
34039034000,0.8490328006728343,0.15096719932716568,1289,0.008410428931875526,1192,446,308,"Census Tract 340, Union County, New Jersey",20,207,187,89,40,361,405,718,1301,2019,598,440,2530,154,0,3444,2378,359,1038,154
34039034100,0.9457044673539519,0.05429553264604811,569,0,1217,224,162,"Census Tract 341, Union County, New Jersey",0,24,35,195,151,35,129,847,529,1376,608,499,2573,86,24,1134,1455,79,1107,110
34039034200,0.9309063893016345,0.06909361069836553,434,0,1770,79,166,"Census Tract 342, Union County, New Jersey",0,80,62,29,97,35,131,813,440,1253,1308,325,2922,99,38,809,1346,93,1633,137
34039034300,0.9686069326357096,0.031393067364290386,396,0,1095,116,292,"Census Tract 343, Union County, New Jersey",0,13,0,92,15,79,197,1053,428,1481,749,335,3263,11,0,694,1529,48,1084,11
34039034400,0.8546120952962737,0.14538790470372634,671,0,1063,61,156,"Census Tract 344, Union County, New Jersey",0,0,67,12,31,113,448,758,641,1399,320,576,2315,52,115,1846,1637,238,896,167
34039034500,0.9796143250688705,0.020385674931129475,1032,0,1213,516,102,"Census Tract 345, Union County, New Jersey",0,13,31,472,56,94,366,854,924,1778,473,669,2702,57,14,1765,1815,37,1142,71
34039034600,0.9118798955613577,0.0881201044386423,856,0,839,179,201,"Census Tract 346, Union County, New Jersey",0,19,13,10,51,84,679,699,698,1397,239,477,2172,91,32,2297,1532,135,716,123
34039034700,0.8748419721871049,0.12515802781289506,1037,0.008217446270543615,1053,75,216,"Census Tract 347, Union County, New Jersey",13,40,138,17,29,76,737,734,650,1384,469,547,2293,37,0,1821,1582,198,1016,37
34039034800,0.966686856450636,0.03331314354936402,88,0,1578,24,262,"Census Tract 348, Union County, New Jersey",0,0,0,0,14,11,63,1493,103,1596,912,608,4417,58,0,358,1651,55,1520,58
34039034900,0.9254166666666667,0.07458333333333333,840,0,1691,223,461,"Census Tract 349, Union County, New Jersey",0,0,249,340,60,98,93,1413,808,2221,692,883,3855,88,28,2009,2400,179,1575,116
34039035000,0.9152709359605912,0.08472906403940887,446,0,910,44,137,"Census Tract 350, Union County, New Jersey",0,6,55,0,0,49,336,638,291,929,320,546,2028,33,11,978,1015,86,866,44
34039035100,0.9123621590249564,0.08763784097504353,1329,0,1269,244,214,"Census Tract 351, Union County, New Jersey",0,297,106,144,121,223,438,650,922,1572,182,608,1806,374,105,2450,1723,151,790,479
34039035200,0.8894967177242888,0.11050328227571116,620,0.009846827133479213,534,39,170,"Census Tract 352, Union County, New Jersey",9,20,0,0,10,201,389,344,469,813,123,252,1285,106,53,1411,914,101,375,159
34039035300,0.9138594802694899,0.08614051973051011,1586,0,1034,265,376,"Census Tract 353, Union County, New Jersey",0,120,8,88,114,244,1012,818,1081,1899,451,394,2320,147,42,3102,2078,179,845,189
34039035400,0.8729338842975206,0.12706611570247933,448,0,771,96,106,"Census Tract 354, Union County, New Jersey",0,0,0,0,2,101,345,577,268,845,396,263,1850,74,38,845,968,123,659,112
34039035500,0.9092088197146563,0.0907911802853437,1391,0,2365,479,333,"Census Tract 355, Union County, New Jersey",0,197,73,216,86,48,771,1735,1069,2804,1175,1078,5205,56,56,2629,3084,280,2253,112
34039035600,0.9322157434402333,0.06778425655976676,39,0,1833,23,143,"Census Tract 356, Union County, New Jersey",0,0,0,0,0,0,39,1203,76,1279,914,911,3380,8,0,238,1372,93,1825,8
34039035700,0.9799906933457422,0.020009306654257795,589,0,1917,78,314,"Census Tract 357, Union County, New Jersey",0,162,108,39,27,138,115,1456,650,2106,1228,663,4299,26,0,1022,2149,43,1891,26
34039035800,0.9448223733938019,0.05517762660619804,524,0,833,276,243,"Census Tract 358, Union County, New Jersey",0,29,18,152,51,37,237,741,509,1250,234,423,2435,144,32,1293,1323,73,657,176
34039035900,0.8574686431014823,0.14253135689851767,1125,0,595,185,469,"Census Tract 359, Union County, New Jersey",0,132,154,513,91,43,192,669,835,1504,238,226,1822,111,20,1943,1754,250,464,131
34039036000,0.920836751435603,0.07916324856439705,1424,0.006562756357670222,967,453,376,"Census Tract 360, Union County, New Jersey",16,0,271,845,17,0,291,737,1508,2245,217,487,2305,97,166,2661,2438,193,704,263
34039036100,0.9959183673469387,0.004081632653061225,391,0,585,47,36,"Census Tract 361, Union County, New Jersey",0,4,0,2,0,310,75,187,545,732,62,82,408,204,237,1166,735,3,144,441
34039036200,1,0,137,0,2492,89,205,"Census Tract 362, Union County, New Jersey",0,15,11,0,12,42,57,2218,159,2377,1215,1265,6237,0,12,233,2377,0,2480,12
34039036301,0.9658158614402917,0.034184138559708296,1022,0,1644,84,339,"Census Tract 363.01, Union County, New Jersey",0,133,354,250,109,57,119,1214,905,2119,800,758,3471,29,57,1609,2194,75,1558,86
34039036302,0.9745699326851159,0.025430067314884067,125,0,1651,15,129,"Census Tract 363.02, Union County, New Jersey",0,31,47,33,5,9,0,1164,139,1303,876,775,3579,0,0,338,1337,34,1651,0
34039036400,0.9742331288343559,0.025766871165644172,330,0,2512,93,760,"Census Tract 364, Union County, New Jersey",0,15,0,16,17,208,74,2273,109,2382,1705,807,6948,0,0,314,2445,63,2512,0
34039036500,0.9730033745781778,0.02699662542182227,83,0.015185601799775027,1833,24,436,"Census Tract 365, Union County, New Jersey",27,7,0,17,34,19,6,1621,109,1730,1192,641,5258,0,0,352,1778,48,1833,0
34039036600,0.89164265129683,0.10835734870317003,774,0,1189,87,460,"Census Tract 366, Union County, New Jersey",0,45,80,16,132,115,386,863,684,1547,516,465,2436,20,188,1625,1735,188,981,208
34039036700,0.9450945094509451,0.05490549054905491,624,0,2350,106,667,"Census Tract 367, Union County, New Jersey",0,23,63,70,114,63,291,1584,516,2100,1387,763,4464,200,0,1044,2222,122,2150,200
34039036800,0.9600146735143067,0.03998532648569332,331,0,2956,117,838,"Census Tract 368, Union County, New Jersey",0,18,0,313,0,0,0,2295,322,2617,1643,1240,7008,73,0,340,2726,109,2883,73
34039036900,0.9662125340599454,0.033787465940054495,794,0,1279,105,263,"Census Tract 369, Union County, New Jersey",0,34,79,0,75,120,486,1060,713,1773,440,639,2820,105,95,1514,1835,62,1079,200
34039037000,0.9595821980018165,0.04041780199818347,279,0,2365,0,458,"Census Tract 370, Union County, New Jersey",0,18,134,0,55,23,49,1922,191,2113,1124,1199,5512,0,42,373,2202,89,2323,42
34039037100,0.9773333333333334,0.02266666666666667,0,0,2361,11,323,"Census Tract 371, Union County, New Jersey",0,0,0,0,0,0,0,1448,18,1466,1295,1066,4256,0,0,57,1500,34,2361,0
34039037200,0.934976402726796,0.06502359727320399,1158,0,1019,162,305,"Census Tract 372, Union County, New Jersey",0,108,84,382,38,107,439,792,991,1783,369,561,2068,89,0,2055,1907,124,930,89
34039037300,0.9669652855543113,0.03303471444568869,190,0,1813,211,277,"Census Tract 373, Union County, New Jersey",0,0,0,159,0,2,29,1489,238,1727,907,873,4367,0,33,307,1786,59,1780,33
34039037400,0.9416365824308063,0.05836341756919374,433,0,1832,10,299,"Census Tract 374, Union County, New Jersey",0,0,0,0,11,17,405,1241,324,1565,783,1049,3734,0,0,884,1662,97,1832,0
34039037500,0.9509345794392523,0.04906542056074766,1155,0,1768,35,497,"Census Tract 375, Union County, New Jersey",0,175,249,237,29,302,163,1323,1119,2442,903,775,3652,16,74,2429,2568,126,1678,90
34039037601,0.9518499746578813,0.0481500253421186,754,0,1606,74,250,"Census Tract 376.01, Union County, New Jersey",0,137,32,151,23,360,51,1332,546,1878,429,1040,3583,129,8,958,1973,95,1469,137
34039037602,0.9488372093023256,0.05116279069767442,1023,0.005366726296958855,2411,223,427,"Census Tract 376.02, Union County, New Jersey",15,182,319,280,145,79,18,1804,848,2652,1444,776,4875,84,107,1874,2795,143,2220,191
34039037700,0.9407894736842105,0.05921052631578947,239,0,1343,48,471,"Census Tract 377, Union County, New Jersey",0,44,49,10,35,54,47,1310,263,1573,675,654,4139,0,14,774,1672,99,1329,14
34039037800,0.97442143727162,0.025578562728380026,1117,0,1219,240,717,"Census Tract 378, Union County, New Jersey",0,220,311,142,176,149,119,1401,999,2400,623,467,3558,112,17,2298,2463,63,1090,129
34039037900,0.9612068965517241,0.03879310344827586,118,0.015086206896551725,1898,80,722,"Census Tract 379, Union County, New Jersey",28,23,18,0,9,38,30,1672,112,1784,1385,513,5115,0,0,270,1856,72,1898,0
34039038000,0.9281875915974597,0.0718124084025403,712,0,1065,160,477,"Census Tract 380, Union County, New Jersey",0,67,118,38,64,105,320,1032,868,1900,279,711,2965,75,0,2585,2047,147,990,75
34039038101,0.9723719676549866,0.027628032345013476,341,0,1418,54,507,"Census Tract 381.01, Union County, New Jersey",0,38,23,79,33,102,66,1208,235,1443,894,524,3707,0,0,367,1484,41,1418,0
34039038102,0.9568854568854569,0.043114543114543116,820,0,3034,149,698,"Census Tract 381.02, Union County, New Jersey",0,176,119,43,106,177,199,2224,750,2974,1700,1153,6902,61,120,1638,3108,134,2853,181
34039038201,0.9690873405299313,0.030912659470068694,31,0,2043,34,441,"Census Tract 382.01, Union County, New Jersey",0,0,0,0,0,31,0,1910,65,1975,1205,822,5680,0,16,226,2038,63,2027,16
34039038202,0.9552703228315831,0.044729677168416956,108,0,2453,105,301,"Census Tract 382.02, Union County, New Jersey",0,0,34,0,15,37,22,2293,163,2456,1189,1247,6750,17,0,404,2571,115,2436,17
34039038300,0.9776785714285714,0.022321428571428572,155,0,2737,130,246,"Census Tract 383, Union County, New Jersey",0,0,0,146,0,0,9,2166,243,2409,1298,1439,6119,0,0,486,2464,55,2737,0
34039038400,0.9721508140531276,0.027849185946872322,422,0,2437,147,402,"Census Tract 384, Union County, New Jersey",0,73,50,0,29,135,135,1799,470,2269,1279,1045,5275,15,98,1027,2334,65,2324,113
34039038500,0.9805502846299811,0.019449715370018977,118,0,1992,25,345,"Census Tract 385, Union County, New Jersey",0,37,0,12,0,46,23,1936,131,2067,1097,869,5577,26,0,318,2108,41,1966,26
34039038601,0.9359281437125748,0.06407185628742515,977,0,2749,138,457,"Census Tract 386.01, Union County, New Jersey",0,126,81,275,126,313,56,2161,965,3126,1587,1031,6027,83,48,1801,3340,214,2618,131
34039038602,0.95783132530120485,0.04216867469879518,15,0,1383,57,353,"Census Tract 386.02, Union County, New Jersey",0,0,15,0,0,0,0,1250,22,1272,871,512,3964,0,0,22,1328,56,1383,0
34039038700,0.9758342922899885,0.024165707710011506,211,0.024165707710011506,2800,163,403,"Census Tract 387, Union County, New Jersey",63,0,145,19,0,11,36,2228,316,2544,1306,1494,6770,0,0,704,2607,63,2800,0
34039038800,0.875,0.125,588,0,1055,135,201,"Census Tract 388, Union County, New Jersey",0,34,82,77,8,135,252,739,710,1449,291,592,1971,98,74,2266,1656,207,883,172
34039038900,0.8839239856189008,0.11607601438109913,1400,0,684,451,191,"Census Tract 389, Union County, New Jersey",0,46,166,241,68,387,492,562,1159,1721,125,445,2119,58,56,4059,1947,226,570,114
34039039000,0.900355871886121,0.099644128113879,1042,0,373,378,133,"Census Tract 390, Union County, New Jersey",0,146,127,177,5,168,419,371,894,1265,168,126,1199,31,48,2831,1405,140,294,79
34039039100,0.9433811802232854,0.05661881977671451,58,0,1144,9,198,"Census Tract 391, Union County, New Jersey",0,0,0,0,0,24,34,1155,28,1183,567,577,3108,0,0,133,1254,71,1144,0
34039039200,0.964167585446527,0.03583241455347299,1203,0,1096,461,473,"Census Tract 392, Union County, New Jersey",0,66,198,103,170,485,181,616,1133,1749,651,277,1828,139,29,3748,1814,65,928,168
34039039300,0.9141705069124424,0.0858294930875576,1371,0,639,825,218,"Census Tract 393, Union County, New Jersey",0,92,306,200,292,188,293,133,1454,1587,50,201,769,203,185,5536,1736,149,251,388
34039039400,0.8823146944083224,0.1176853055916775,712,0,856,253,184,"Census Tract 394, Union County, New Jersey",0,81,38,78,30,154,331,624,733,1357,284,434,2257,138,0,2261,1538,181,718,138
34039039500,0.9146608315098468,0.08533916849015317,564,0,1195,246,153,"Census Tract 395, Union County, New Jersey",0,37,92,18,0,54,363,900,772,1672,348,675,3465,72,100,2655,1828,156,1023,172
34039039600,0.9624595469255663,0.037540453074433655,641,0.010355987055016181,1279,239,276,"Census Tract 396, Union County, New Jersey",16,50,139,125,43,92,192,875,612,1487,672,511,2346,66,30,1616,1545,58,1183,96
34039039700,0.982124079915878,0.017875920084121977,672,0.006309148264984227,1326,164,201,"Census Tract 397, Union County, New Jersey",12,55,96,122,69,168,162,1113,755,1868,481,790,3014,28,27,2138,1902,34,1271,55
34039039800,0.8759221998658618,0.12407780013413816,1126,0,567,385,167,"Census Tract 398, Union County, New Jersey",0,21,21,0,253,314,517,292,1014,1306,173,104,949,234,56,3515,1491,185,277,290
34039039900,0.9132653061224489,0.08673469387755102,551,0,135,320,71,"Census Tract 399, Union County, New Jersey",0,94,78,167,63,88,61,29,508,537,0,44,157,84,7,1011,588,51,44,91
34041030600,0.9096605744125327,0.09033942558746737,712,0,1043,272,24,"Census Tract 306, Warren County, New Jersey",0,64,67,193,93,174,121,895,847,1742,404,532,2101,83,24,1614,1915,173,936,107
34041030700,0.7961956521739131,0.20380434782608695,741,0,990,151,35,"Census Tract 307, Warren County, New Jersey",0,42,16,0,172,176,335,956,802,1758,296,599,2215,95,0,2337,2208,450,895,95
34041030800,0.8750918442321822,0.12490815576781777,316,0.0073475385745775165,1040,107,10,"Census Tract 308, Warren County, New Jersey",10,9,45,13,128,72,49,748,443,1191,612,365,1948,63,0,979,1361,170,977,63
34041030900,0.8238805970149253,0.1761194029850746,519,0,676,245,9,"Census Tract 309, Warren County, New Jersey",0,40,25,53,151,124,126,557,547,1104,441,211,1474,6,18,1665,1340,236,652,24
34041031101,0.8629232039636664,0.1370767960363336,122,0.00495458298926507,2008,53,17,"Census Tract 311.01, Warren County, New Jersey",12,0,0,0,22,0,100,1915,175,2090,1066,848,5246,0,94,431,2422,332,1914,94
34041031102,0.9200833912439194,0.07991660875608061,36,0.009728978457261988,1472,17,19,"Census Tract 311.02, Warren County, New Jersey",14,0,0,0,0,0,36,1177,147,1324,730,694,3259,29,19,386,1439,115,1424,48
34041031200,0.8804719031356721,0.11952809686432785,137,0.022042843837317604,2895,97,15,"Census Tract 312, Warren County, New Jersey",71,24,0,0,30,0,83,2372,464,2836,1609,1188,6510,57,41,1072,3221,385,2797,98
34041031301,0.9457167090754877,0.0542832909245123,728,0,1608,73,2,"Census Tract 313.01, Warren County, New Jersey",0,102,72,46,291,52,165,1708,522,2230,867,563,4254,163,15,1213,2358,128,1430,178
34041031302,0.9556650246305419,0.04433497536945813,438,0,1232,67,29,"Census Tract 313.02, Warren County, New Jersey",0,12,0,12,234,107,73,1794,340,2134,960,272,3782,0,0,786,2233,99,1232,0
34041031401,0.9761904761904762,0.023809523809523808,587,0,1000,217,0,"Census Tract 314.01, Warren County, New Jersey",0,133,16,109,72,162,95,978,662,1640,419,542,3015,21,18,1451,1680,40,961,39
34041031402,0.9501590668080594,0.04984093319194061,718,0.01166489925768823,1218,98,33,"Census Tract 314.02, Warren County, New Jersey",22,99,181,38,244,62,94,902,890,1792,623,521,2252,48,26,2029,1886,94,1144,74
34041031500,0.8845568077977459,0.11544319220225403,1221,0,2023,212,96,"Census Tract 315, Warren County, New Jersey",0,796,21,22,190,155,37,1790,1114,2904,825,1084,5066,114,0,2236,3283,379,1909,114
34041031601,0.9058277027027027,0.0941722972972973,543,0.04771959459459459,1843,230,0,"Census Tract 316.01, Warren County, New Jersey",113,170,46,160,18,0,149,1584,561,2145,718,1091,3669,34,0,871,2368,223,1809,34
34041031602,0.9550342130987293,0.044965786901270774,109,0.10459433040078202,720,42,33,"Census Tract 316.02, Warren County, New Jersey",107,6,10,0,0,71,22,818,159,977,435,280,2197,0,5,243,1023,46,715,5
34041031700,0.8486159169550173,0.1513840830449827,377,0,722,111,10,"Census Tract 317, Warren County, New Jersey",0,63,17,16,81,120,80,557,424,981,408,210,1719,77,27,854,1156,175,618,104
34041031800,0.9348441926345609,0.06515580736543909,54,0,1088,21,0,"Census Tract 318, Warren County, New Jersey",0,0,0,0,0,18,36,877,113,990,551,506,2390,11,20,265,1059,69,1057,31
34041031900,0.9369369369369369,0.06306306306306306,17,0.015667841754798278,2207,97,60,"Census Tract 319, Warren County, New Jersey",40,0,0,0,0,0,17,2255,137,2392,938,1221,6089,48,0,335,2553,161,2159,48
34041032000,0.9254571026722925,0.07454289732770746,1104,0,1434,217,165,"Census Tract 320, Warren County, New Jersey",0,70,132,97,177,215,413,1353,1279,2632,459,850,3963,125,0,2482,2844,212,1309,125
34041032101,0.9415807560137457,0.058419243986254296,39,0.07302405498281787,1366,18,10,"Census Tract 321.01, Warren County, New Jersey",85,0,0,6,0,16,17,988,108,1096,724,623,2764,0,19,281,1164,68,1347,19
34041032102,0.9678778304370721,0.032122169562927856,96,0.011058451816745656,2234,26,21,"Census Tract 321.02, Warren County, New Jersey",21,0,0,0,8,34,54,1596,242,1838,1784,425,4885,0,25,618,1899,61,2209,25
34041032200,0.9410935738444194,0.05890642615558061,919,0,3000,217,60,"Census Tract 322, Warren County, New Jersey",0,250,35,179,311,33,111,2200,1139,3339,1680,1249,5994,31,40,2016,3548,209,2929,71
34041032300,0.9046624913013221,0.0953375086986778,68,0,1373,27,14,"Census Tract 323, Warren County, New Jersey",0,0,0,0,0,27,41,1058,242,1300,804,520,2472,40,9,745,1437,137,1324,49
34041032400,0.8747609942638623,0.12523900573613767,234,0,720,41,7,"Census Tract 324, Warren County, New Jersey",0,43,12,14,19,79,67,645,270,915,247,415,1578,52,6,500,1046,131,662,58
